"datetime","shortId","shortGroup","description","type","kind","isRefund","isRefunded","shortRefundId","displayAmount","amount","paymentProcessorFee","netAmount","balance","currency","accountSlug","accountName","oppositeAccountSlug","oppositeAccountName","paymentMethodService","paymentMethodType","expenseType","expenseTags","payoutMethodType","merchantId","orderMemo"
"2023-11-03T11:51:06","d1000bda","45a3213b","Expense from Jakub Zárybnický - Bounty for #425","DEBIT","EXPENSE","","","","-$100.00 USD",-100,-0.88,-100.88,7460.48,"USD","hledger","hledger","jakub-zarybnicky","Jakub Zárybnický",,,"INVOICE","","BANK_ACCOUNT",,
"2023-11-01T23:03:30","73d02876","9e6bb2e3","Monthly contribution from Aviator Game (Individuals)","CREDIT","CONTRIBUTION","","","","$5.00 USD",5,-0.52,4.48,7561.36,"USD","hledger","hledger","aviator-game1","Aviator Game","STRIPE","CREDITCARD",,"",,,
"2023-11-01T23:03:30","28d7af86","9e6bb2e3","Host Fee to Open Source Collective","DEBIT","HOST_FEE","","","","-$0.50 USD",-0.5,0,-0.5,7556.88,"USD","hledger","hledger","opensource","Open Source Collective",,,,"",,,
"2023-11-01T14:03:16","fdc89ee4","d4844e65","Monthly contribution from Frank (Individuals)","CREDIT","CONTRIBUTION","","","","$2.00 USD",2,-0.36,1.64,7557.38,"USD","hledger","hledger","guest-4c0726ae","Frank","STRIPE","CREDITCARD",,"",,,
"2023-11-01T14:03:16","aa36f63d","d4844e65","Host Fee to Open Source Collective","DEBIT","HOST_FEE","","","","-$0.20 USD",-0.2,0,-0.2,7555.74,"USD","hledger","hledger","opensource","Open Source Collective",,,,"",,,
"2023-11-01T12:08:15","c2ac8c10","3169eebd","Monthly contribution from Ken Ewing (Individuals)","CREDIT","CONTRIBUTION","","","","$2.00 USD",2,-0.36,1.64,7555.94,"USD","hledger","hledger","ken-ewing","Ken Ewing","STRIPE","CREDITCARD",,"",,,
"2023-11-01T12:08:15","76349fa1","3169eebd","Host Fee to Open Source Collective","DEBIT","HOST_FEE","","","","-$0.20 USD",-0.2,0,-0.2,7554.3,"USD","hledger","hledger","opensource","Open Source Collective",,,,"",,,
"2023-11-01T08:58:41","a8e0cc68","8f61c352","Monthly contribution from Samim Pezeshki (Individuals)","CREDIT","CONTRIBUTION","","","","$2.00 USD",2,-0.59,1.41,7554.5,"USD","hledger","hledger","samim-pezeshki","Samim Pezeshki","PAYPAL","SUBSCRIPTION",,"",,,
"2023-11-01T08:58:40","3c293b65","8f61c352","Host Fee to Open Source Collective","DEBIT","HOST_FEE","","","","-$0.20 USD",-0.2,0,-0.2,7553.09,"USD","hledger","hledger","opensource","Open Source Collective",,,,"",,,
"2023-11-01T08:10:11","6ed91611","e0da96fd","Monthly contribution from James Blachly (Individuals)","CREDIT","CONTRIBUTION","","","","$2.00 USD",2,-0.36,1.64,7553.29,"USD","hledger","hledger","james-blachly","James Blachly","STRIPE","CREDITCARD",,"",,,
"2023-11-01T08:10:11","ac35167c","e0da96fd","Host Fee to Open Source Collective","DEBIT","HOST_FEE","","","","-$0.20 USD",-0.2,0,-0.2,7551.65,"USD","hledger","hledger","opensource","Open Source Collective",,,,"",,,
"2023-11-01T04:05:41","a4938268","a9443bdc","Monthly contribution from Jack Todaro (Individuals)","CREDIT","CONTRIBUTION","","","","$2.00 USD",2,-0.39,1.61,7551.85,"USD","hledger","hledger","jack-todaro","Jack Todaro","STRIPE","CREDITCARD",,"",,,
"2023-11-01T04:05:41","8a35e0a6","a9443bdc","Host Fee to Open Source Collective","DEBIT","HOST_FEE","","","","-$0.20 USD",-0.2,0,-0.2,7550.24,"USD","hledger","hledger","opensource","Open Source Collective",,,,"",,,
"2023-11-01T02:10:38","bbeebe98","59af2ebd","Monthly contribution from October Swimmer (Organisations)","CREDIT","CONTRIBUTION","","","","$100.00 USD",100,-3.2,96.8,7550.44,"USD","hledger","hledger","october-swimmer","October Swimmer","STRIPE","CREDITCARD",,"",,,
"2023-11-01T02:10:37","78df481e","59af2ebd","Host Fee to Open Source Collective","DEBIT","HOST_FEE","","","","-$10.00 USD",-10,0,-10,7453.64,"USD","hledger","hledger","opensource","Open Source Collective",,,,"",,,
"2023-11-01T02:06:16","b09587e1","d3ea7396","Monthly contribution from Brandon Barker (Individuals)","CREDIT","CONTRIBUTION","","","","$2.00 USD",2,-0.36,1.64,7463.64,"USD","hledger","hledger","brandonbarker","Brandon Barker","STRIPE","CREDITCARD",,"",,,
"2023-11-01T02:06:16","71258f0f","d3ea7396","Host Fee to Open Source Collective","DEBIT","HOST_FEE","","","","-$0.20 USD",-0.2,0,-0.2,7462,"USD","hledger","hledger","opensource","Open Source Collective",,,,"",,,
"2023-11-01T01:10:04","2b527fbd","94165301","Monthly contribution from Rishi Hyanki (Individuals)","CREDIT","CONTRIBUTION","","","","$2.00 USD",2,-0.36,1.64,7462.2,"USD","hledger","hledger","rhyanki","Rishi Hyanki","STRIPE","CREDITCARD",,"",,,
"2023-11-01T01:10:03","1dab377f","94165301","Host Fee to Open Source Collective","DEBIT","HOST_FEE","","","","-$0.20 USD",-0.2,0,-0.2,7460.56,"USD","hledger","hledger","opensource","Open Source Collective",,,,"",,,
"2023-10-31T10:29:13","0b7163f0","d7c31dfd","Monthly contribution from Richard Kelly (Individuals)","CREDIT","CONTRIBUTION","","","","$2.00 USD",2,-0.56,1.44,7460.76,"USD","hledger","hledger","richard-kelly","Richard Kelly","PAYPAL","SUBSCRIPTION",,"",,,
"2023-10-31T10:29:13","43967bb7","d7c31dfd","Host Fee to Open Source Collective","DEBIT","HOST_FEE","","","","-$0.20 USD",-0.2,0,-0.2,7459.32,"USD","hledger","hledger","opensource","Open Source Collective",,,,"",,,
"2023-10-23T11:34:31","3962b474","2bc9951e","Monthly contribution from Guest (Individuals)","CREDIT","CONTRIBUTION","","","","$2.00 USD",2,-0.59,1.41,7459.52,"USD","hledger","hledger","guest-d120c27f","Guest","PAYPAL","SUBSCRIPTION",,"",,,
"2023-10-23T11:34:31","0927546d","2bc9951e","Host Fee to Open Source Collective","DEBIT","HOST_FEE","","","","-$0.20 USD",-0.2,0,-0.2,7458.11,"USD","hledger","hledger","opensource","Open Source Collective",,,,"",,,
"2023-10-20T15:52:44","4df9451b","9b3f5f96","Contribution to Sandstorm","DEBIT","CONTRIBUTION","","","","-$100.00 USD",-100,0,-100,7458.31,"USD","hledger","hledger","sandstormcommunity","Sandstorm","OPENCOLLECTIVE","COLLECTIVE",,"",,,
"2023-10-17T23:02:38","6b91441c","ae65da3b","Expense from Petr Slansky - Regression bounty for #2091","DEBIT","EXPENSE","","","","-$100.00 USD",-100,-2,-102,7558.31,"USD","hledger","hledger","petr-slansky","Petr Slansky",,,"INVOICE","","PAYPAL",,
"2023-10-17T17:00:55","3c526232","2f165862","Expense from Pranesh Prakash - Regression bounty for #2045","DEBIT","EXPENSE","","","","-$100.00 USD",-100,-2,-102,7660.31,"USD","hledger","hledger","pranesh-prakash","Pranesh Prakash",,,"INVOICE","","PAYPAL",,
"2023-10-01T23:04:24","f61c6131","af2cc7c3","Monthly contribution from Aviator Game (Individuals)","CREDIT","CONTRIBUTION","","","","$5.00 USD",5,-0.52,4.48,7762.31,"USD","hledger","hledger","aviator-game1","Aviator Game","STRIPE","CREDITCARD",,"",,,
"2023-10-01T23:04:24","eeda7e73","af2cc7c3","Host Fee to Open Source Collective","DEBIT","HOST_FEE","","","","-$0.50 USD",-0.5,0,-0.5,7757.83,"USD","hledger","hledger","opensource","Open Source Collective",,,,"",,,
"2023-10-01T14:06:52","44bdde77","2cee6ceb","Monthly contribution from Frank (Individuals)","CREDIT","CONTRIBUTION","","","","$2.00 USD",2,-0.36,1.64,7758.33,"USD","hledger","hledger","guest-4c0726ae","Frank","STRIPE","CREDITCARD",,"",,,
"2023-10-01T14:06:52","fc251e1e","2cee6ceb","Host Fee to Open Source Collective","DEBIT","HOST_FEE","","","","-$0.20 USD",-0.2,0,-0.2,7756.69,"USD","hledger","hledger","opensource","Open Source Collective",,,,"",,,
"2023-10-01T12:10:27","19ef7ba2","34697788","Monthly contribution from Ken Ewing (Individuals)","CREDIT","CONTRIBUTION","","","","$2.00 USD",2,-0.36,1.64,7756.89,"USD","hledger","hledger","ken-ewing","Ken Ewing","STRIPE","CREDITCARD",,"",,,
"2023-10-01T12:10:27","d12d5e86","34697788","Host Fee to Open Source Collective","DEBIT","HOST_FEE","","","","-$0.20 USD",-0.2,0,-0.2,7755.25,"USD","hledger","hledger","opensource","Open Source Collective",,,,"",,,
"2023-10-01T09:03:13","1b987609","5a31a881","Monthly contribution from James Blachly (Individuals)","CREDIT","CONTRIBUTION","","","","$2.00 USD",2,-0.36,1.64,7755.45,"USD","hledger","hledger","james-blachly","James Blachly","STRIPE","CREDITCARD",,"",,,
"2023-10-01T09:03:13","5a7024cf","5a31a881","Host Fee to Open Source Collective","DEBIT","HOST_FEE","","","","-$0.20 USD",-0.2,0,-0.2,7753.81,"USD","hledger","hledger","opensource","Open Source Collective",,,,"",,,
"2023-10-01T04:07:01","8fa848d2","ff9a125b","Monthly contribution from Jack Todaro (Individuals)","CREDIT","CONTRIBUTION","","","","$2.00 USD",2,-0.39,1.61,7754.01,"USD","hledger","hledger","jack-todaro","Jack Todaro","STRIPE","CREDITCARD",,"",,,
"2023-10-01T04:07:01","25d027d6","ff9a125b","Host Fee to Open Source Collective","DEBIT","HOST_FEE","","","","-$0.20 USD",-0.2,0,-0.2,7752.4,"USD","hledger","hledger","opensource","Open Source Collective",,,,"",,,
"2023-10-01T02:11:22","9d8250a0","ab8769f6","Monthly contribution from October Swimmer (Organisations)","CREDIT","CONTRIBUTION","","","","$100.00 USD",100,-3.2,96.8,7752.6,"USD","hledger","hledger","october-swimmer","October Swimmer","STRIPE","CREDITCARD",,"",,,
"2023-10-01T02:11:21","57a19e55","ab8769f6","Host Fee to Open Source Collective","DEBIT","HOST_FEE","","","","-$10.00 USD",-10,0,-10,7655.8,"USD","hledger","hledger","opensource","Open Source Collective",,,,"",,,
"2023-10-01T02:06:22","2c7b79a8","21f24a73","Monthly contribution from Brandon Barker (Individuals)","CREDIT","CONTRIBUTION","","","","$2.00 USD",2,-0.36,1.64,7665.8,"USD","hledger","hledger","brandonbarker","Brandon Barker","STRIPE","CREDITCARD",,"",,,
"2023-10-01T02:06:22","cacabd4d","21f24a73","Host Fee to Open Source Collective","DEBIT","HOST_FEE","","","","-$0.20 USD",-0.2,0,-0.2,7664.16,"USD","hledger","hledger","opensource","Open Source Collective",,,,"",,,
"2023-10-01T01:10:16","1f98e478","7b56df02","Monthly contribution from Rishi Hyanki (Individuals)","CREDIT","CONTRIBUTION","","","","$2.00 USD",2,-0.36,1.64,7664.36,"USD","hledger","hledger","rhyanki","Rishi Hyanki","STRIPE","CREDITCARD",,"",,,
"2023-10-01T01:10:16","34f09e02","7b56df02","Host Fee to Open Source Collective","DEBIT","HOST_FEE","","","","-$0.20 USD",-0.2,0,-0.2,7662.72,"USD","hledger","hledger","opensource","Open Source Collective",,,,"",,,
"2023-09-30T11:41:17","a71434b4","5a7e5921","Monthly contribution from Richard Kelly (Individuals)","CREDIT","CONTRIBUTION","","","","$2.00 USD",2,-0.56,1.44,7662.92,"USD","hledger","hledger","richard-kelly","Richard Kelly","PAYPAL","SUBSCRIPTION",,"",,,
"2023-09-30T11:41:17","da88f17e","5a7e5921","Host Fee to Open Source Collective","DEBIT","HOST_FEE","","","","-$0.20 USD",-0.2,0,-0.2,7661.48,"USD","hledger","hledger","opensource","Open Source Collective",,,,"",,,
"2023-09-23T10:57:14","1b0972eb","3cd96a28","Monthly contribution from Guest (Individuals)","CREDIT","CONTRIBUTION","","","","$2.00 USD",2,-0.59,1.41,7661.68,"USD","hledger","hledger","guest-d120c27f","Guest","PAYPAL","SUBSCRIPTION",,"",,,
"2023-09-23T10:57:14","8e76fb34","3cd96a28","Host Fee to Open Source Collective","DEBIT","HOST_FEE","","","","-$0.20 USD",-0.2,0,-0.2,7660.27,"USD","hledger","hledger","opensource","Open Source Collective",,,,"",,,
"2023-09-02T00:05:15","b9968b5c","2fd65273","Monthly contribution from Aviator Game (Individuals)","CREDIT","CONTRIBUTION","","","","$5.00 USD",5,-0.52,4.48,7660.47,"USD","hledger","hledger","aviator-game1","Aviator Game","STRIPE","CREDITCARD",,"",,,
"2023-09-02T00:05:15","1ce2f60d","2fd65273","Host Fee to Open Source Collective","DEBIT","HOST_FEE","","","","-$0.50 USD",-0.5,0,-0.5,7655.99,"USD","hledger","hledger","opensource","Open Source Collective",,,,"",,,
"2023-09-01T15:01:04","c3b663b1","7f2747a2","Monthly contribution from Frank (Individuals)","CREDIT","CONTRIBUTION","","","","$2.00 USD",2,-0.36,1.64,7656.49,"USD","hledger","hledger","guest-4c0726ae","Frank","STRIPE","CREDITCARD",,"",,,
"2023-09-01T15:01:04","f251be20","7f2747a2","Host Fee to Open Source Collective","DEBIT","HOST_FEE","","","","-$0.20 USD",-0.2,0,-0.2,7654.85,"USD","hledger","hledger","opensource","Open Source Collective",,,,"",,,
"2023-09-01T13:06:07","5312bbc1","e81c725c","Monthly contribution from Ken Ewing (Individuals)","CREDIT","CONTRIBUTION","","","","$2.00 USD",2,-0.36,1.64,7655.05,"USD","hledger","hledger","ken-ewing","Ken Ewing","STRIPE","CREDITCARD",,"",,,
"2023-09-01T13:06:07","4b5dd306","e81c725c","Host Fee to Open Source Collective","DEBIT","HOST_FEE","","","","-$0.20 USD",-0.2,0,-0.2,7653.41,"USD","hledger","hledger","opensource","Open Source Collective",,,,"",,,
"2023-09-01T09:06:36","b2e322ec","b571278f","Monthly contribution from James Blachly (Individuals)","CREDIT","CONTRIBUTION","","","","$2.00 USD",2,-0.36,1.64,7653.61,"USD","hledger","hledger","james-blachly","James Blachly","STRIPE","CREDITCARD",,"",,,
"2023-09-01T09:06:36","0e9ed45a","b571278f","Host Fee to Open Source Collective","DEBIT","HOST_FEE","","","","-$0.20 USD",-0.2,0,-0.2,7651.97,"USD","hledger","hledger","opensource","Open Source Collective",,,,"",,,
"2023-09-01T04:07:46","6a493c32","f05bbe79","Monthly contribution from Jack Todaro (Individuals)","CREDIT","CONTRIBUTION","","","","$2.00 USD",2,-0.39,1.61,7652.17,"USD","hledger","hledger","jack-todaro","Jack Todaro","STRIPE","CREDITCARD",,"",,,
"2023-09-01T04:07:46","8d2b6362","f05bbe79","Host Fee to Open Source Collective","DEBIT","HOST_FEE","","","","-$0.20 USD",-0.2,0,-0.2,7650.56,"USD","hledger","hledger","opensource","Open Source Collective",,,,"",,,
"2023-09-01T03:01:28","8c0c66c6","93fe4d06","Monthly contribution from October Swimmer (Organisations)","CREDIT","CONTRIBUTION","","","","$100.00 USD",100,-3.2,96.8,7650.76,"USD","hledger","hledger","october-swimmer","October Swimmer","STRIPE","CREDITCARD",,"",,,
"2023-09-01T03:01:28","97b848a1","93fe4d06","Host Fee to Open Source Collective","DEBIT","HOST_FEE","","","","-$10.00 USD",-10,0,-10,7553.96,"USD","hledger","hledger","opensource","Open Source Collective",,,,"",,,
"2023-09-01T02:05:19","acef875e","e63b8e39","Monthly contribution from Brandon Barker (Individuals)","CREDIT","CONTRIBUTION","","","","$2.00 USD",2,-0.36,1.64,7563.96,"USD","hledger","hledger","brandonbarker","Brandon Barker","STRIPE","CREDITCARD",,"",,,
"2023-09-01T02:05:19","1b25976a","e63b8e39","Host Fee to Open Source Collective","DEBIT","HOST_FEE","","","","-$0.20 USD",-0.2,0,-0.2,7562.32,"USD","hledger","hledger","opensource","Open Source Collective",,,,"",,,
"2023-09-01T02:01:00","269a6d23","f6706c77","Monthly contribution from Rishi Hyanki (Individuals)","CREDIT","CONTRIBUTION","","","","$2.00 USD",2,-0.36,1.64,7562.52,"USD","hledger","hledger","rhyanki","Rishi Hyanki","STRIPE","CREDITCARD",,"",,,
"2023-09-01T02:01:00","e2dee5fb","f6706c77","Host Fee to Open Source Collective","DEBIT","HOST_FEE","","","","-$0.20 USD",-0.2,0,-0.2,7560.88,"USD","hledger","hledger","opensource","Open Source Collective",,,,"",,,
"2023-08-31T10:48:01","578b650e","1f2779e0","Monthly contribution from Richard Kelly (Individuals)","CREDIT","CONTRIBUTION","","","","$2.00 USD",2,-0.56,1.44,7561.08,"USD","hledger","hledger","richard-kelly","Richard Kelly","PAYPAL","SUBSCRIPTION",,"",,,
"2023-08-31T10:48:01","9ebdf03f","1f2779e0","Host Fee to Open Source Collective","DEBIT","HOST_FEE","","","","-$0.20 USD",-0.2,0,-0.2,7559.64,"USD","hledger","hledger","opensource","Open Source Collective",,,,"",,,
"2023-08-24T11:37:06","1ca7dfaf","09950ca8","Monthly contribution from Olsens Revision ApS (Individuals)","CREDIT","CONTRIBUTION","","","","$25.00 USD",25,-1.74,23.26,7559.84,"USD","hledger","hledger","olsensrevision","Olsens Revision ApS","PAYPAL","SUBSCRIPTION",,"",,,
"2023-08-24T11:37:06","557385d2","09950ca8","Host Fee to Open Source Collective","DEBIT","HOST_FEE","","","","-$2.50 USD",-2.5,0,-2.5,7536.58,"USD","hledger","hledger","opensource","Open Source Collective",,,,"",,,
"2023-08-23T18:48:12","0e13cd18","5f5a3c6f","Contribution from J-1Waiver.com","CREDIT","CONTRIBUTION","","","","$1.00 USD",1,-0.34,0.66,7539.08,"USD","hledger","hledger","j-1waiver","J-1Waiver.com",,,,"",,,
"2023-08-23T18:48:12","3efb2970","5f5a3c6f","Host Fee to Open Source Collective","DEBIT","HOST_FEE","","","","-$0.10 USD",-0.1,0,-0.1,7538.42,"USD","hledger","hledger","opensource","Open Source Collective",,,,"",,,
"2023-08-23T11:31:13","f507f081","e2ca3905","Monthly contribution from Guest (Individuals)","CREDIT","CONTRIBUTION","","","","$2.00 USD",2,-0.59,1.41,7538.52,"USD","hledger","hledger","guest-d120c27f","Guest","PAYPAL","SUBSCRIPTION",,"",,,
"2023-08-23T11:31:13","4364a8f5","e2ca3905","Host Fee to Open Source Collective","DEBIT","HOST_FEE","","","","-$0.20 USD",-0.2,0,-0.2,7537.11,"USD","hledger","hledger","opensource","Open Source Collective",,,,"",,,
"2023-08-02T08:04:35","6290ef5c","0feebd50","Contribution from Bharath Chandra Sudheer","CREDIT","CONTRIBUTION","","","","$25.00 USD",25,-1.4,23.6,7537.31,"USD","hledger","hledger","bharathcs","Bharath Chandra Sudheer","STRIPE","CREDITCARD",,"",,,
"2023-08-02T08:04:35","4b3e8e2f","0feebd50","Host Fee to Open Source Collective","DEBIT","HOST_FEE","","","","-$2.50 USD",-2.5,0,-2.5,7513.71,"USD","hledger","hledger","opensource","Open Source Collective",,,,"",,,
"2023-08-02T01:03:27","c59f7f0e","b5ed51c3","Monthly contribution from Aviator Game (Individuals)","CREDIT","CONTRIBUTION","","","","$5.00 USD",5,-0.52,4.48,7516.21,"USD","hledger","hledger","aviator-game1","Aviator Game","STRIPE","CREDITCARD",,"",,,
"2023-08-02T01:03:27","0449031a","b5ed51c3","Host Fee to Open Source Collective","DEBIT","HOST_FEE","","","","-$0.50 USD",-0.5,0,-0.5,7511.73,"USD","hledger","hledger","opensource","Open Source Collective",,,,"",,,
"2023-08-01T15:05:51","0d503db1","1caf656c","Monthly contribution from Frank (Individuals)","CREDIT","CONTRIBUTION","","","","$2.00 USD",2,-0.36,1.64,7512.23,"USD","hledger","hledger","guest-4c0726ae","Frank","STRIPE","CREDITCARD",,"",,,
"2023-08-01T15:05:51","9d84302f","1caf656c","Host Fee to Open Source Collective","DEBIT","HOST_FEE","","","","-$0.20 USD",-0.2,0,-0.2,7510.59,"USD","hledger","hledger","opensource","Open Source Collective",,,,"",,,
"2023-08-01T13:10:12","b9c4037a","d48d98be","Monthly contribution from Ken Ewing (Individuals)","CREDIT","CONTRIBUTION","","","","$2.00 USD",2,-0.36,1.64,7510.79,"USD","hledger","hledger","ken-ewing","Ken Ewing","STRIPE","CREDITCARD",,"",,,
"2023-08-01T13:10:12","a4c1c44b","d48d98be","Host Fee to Open Source Collective","DEBIT","HOST_FEE","","","","-$0.20 USD",-0.2,0,-0.2,7509.15,"USD","hledger","hledger","opensource","Open Source Collective",,,,"",,,
"2023-08-01T11:06:53","3b653cba","7841e666","Monthly contribution from Brandon J Wong (Individuals)","CREDIT","CONTRIBUTION","","","","$2.00 USD",2,-0.39,1.61,7509.35,"USD","hledger","hledger","brandon-j-wong","Brandon J Wong",,,,"",,,
"2023-08-01T11:06:53","50af092f","7841e666","Host Fee to Open Source Collective","DEBIT","HOST_FEE","","","","-$0.20 USD",-0.2,0,-0.2,7507.74,"USD","hledger","hledger","opensource","Open Source Collective",,,,"",,,
"2023-08-01T09:08:41","b8963a07","1f1b9af4","Monthly contribution from James Blachly (Individuals)","CREDIT","CONTRIBUTION","","","","$2.00 USD",2,-0.36,1.64,7507.94,"USD","hledger","hledger","james-blachly","James Blachly","STRIPE","CREDITCARD",,"",,,
"2023-08-01T09:08:41","6f6aada0","1f1b9af4","Host Fee to Open Source Collective","DEBIT","HOST_FEE","","","","-$0.20 USD",-0.2,0,-0.2,7506.3,"USD","hledger","hledger","opensource","Open Source Collective",,,,"",,,
"2023-08-01T04:09:57","cd19ff88","a0825942","Monthly contribution from Jack Todaro (Individuals)","CREDIT","CONTRIBUTION","","","","$2.00 USD",2,-0.39,1.61,7506.5,"USD","hledger","hledger","jack-todaro","Jack Todaro","STRIPE","CREDITCARD",,"",,,
"2023-08-01T04:09:57","723b4669","a0825942","Host Fee to Open Source Collective","DEBIT","HOST_FEE","","","","-$0.20 USD",-0.2,0,-0.2,7504.89,"USD","hledger","hledger","opensource","Open Source Collective",,,,"",,,
"2023-08-01T03:03:26","dc470b8c","4f92122a","Monthly contribution from October Swimmer (Organisations)","CREDIT","CONTRIBUTION","","","","$100.00 USD",100,-3.2,96.8,7505.09,"USD","hledger","hledger","october-swimmer","October Swimmer","STRIPE","CREDITCARD",,"",,,
"2023-08-01T03:03:26","2759348d","4f92122a","Host Fee to Open Source Collective","DEBIT","HOST_FEE","","","","-$10.00 USD",-10,0,-10,7408.29,"USD","hledger","hledger","opensource","Open Source Collective",,,,"",,,
"2023-08-01T02:07:15","b0b7e85b","5e03c87b","Monthly contribution from Brandon Barker (Individuals)","CREDIT","CONTRIBUTION","","","","$2.00 USD",2,-0.36,1.64,7418.29,"USD","hledger","hledger","brandonbarker","Brandon Barker","STRIPE","CREDITCARD",,"",,,
"2023-08-01T02:07:15","044286e7","5e03c87b","Host Fee to Open Source Collective","DEBIT","HOST_FEE","","","","-$0.20 USD",-0.2,0,-0.2,7416.65,"USD","hledger","hledger","opensource","Open Source Collective",,,,"",,,
"2023-08-01T02:02:30","e6c96feb","1f480101","Monthly contribution from Rishi Hyanki (Individuals)","CREDIT","CONTRIBUTION","","","","$2.00 USD",2,-0.36,1.64,7416.85,"USD","hledger","hledger","rhyanki","Rishi Hyanki","STRIPE","CREDITCARD",,"",,,
"2023-08-01T02:02:30","c680784a","1f480101","Host Fee to Open Source Collective","DEBIT","HOST_FEE","","","","-$0.20 USD",-0.2,0,-0.2,7415.21,"USD","hledger","hledger","opensource","Open Source Collective",,,,"",,,
"2023-07-31T11:11:21","3304597f","1d9a6056","Monthly contribution from Richard Kelly (Individuals)","CREDIT","CONTRIBUTION","","","","$2.00 USD",2,-0.56,1.44,7415.41,"USD","hledger","hledger","richard-kelly","Richard Kelly","PAYPAL","SUBSCRIPTION",,"",,,
"2023-07-31T11:11:21","a7766086","1d9a6056","Host Fee to Open Source Collective","DEBIT","HOST_FEE","","","","-$0.20 USD",-0.2,0,-0.2,7413.97,"USD","hledger","hledger","opensource","Open Source Collective",,,,"",,,
"2023-07-24T10:03:16","a0ea0ace","8bfb36f7","Monthly contribution from Olsens Revision ApS (Individuals)","CREDIT","CONTRIBUTION","","","","$25.00 USD",25,-1.74,23.26,7414.17,"USD","hledger","hledger","olsensrevision","Olsens Revision ApS","PAYPAL","SUBSCRIPTION",,"",,,
"2023-07-24T10:03:16","29445706","8bfb36f7","Host Fee to Open Source Collective","DEBIT","HOST_FEE","","","","-$2.50 USD",-2.5,0,-2.5,7390.91,"USD","hledger","hledger","opensource","Open Source Collective",,,,"",,,
"2023-07-23T11:11:18","6501d87d","6dc28dbe","Monthly contribution from Guest (Individuals)","CREDIT","CONTRIBUTION","","","","$2.00 USD",2,-0.59,1.41,7393.41,"USD","hledger","hledger","guest-d120c27f","Guest","PAYPAL","SUBSCRIPTION",,"",,,
"2023-07-23T11:11:18","c438eb85","6dc28dbe","Host Fee to Open Source Collective","DEBIT","HOST_FEE","","","","-$0.20 USD",-0.2,0,-0.2,7392,"USD","hledger","hledger","opensource","Open Source Collective",,,,"",,,
"2023-07-02T13:07:37","959de6a0","4bbd99fc","Monthly contribution from Markus Schmitz (Individuals)","CREDIT","CONTRIBUTION","","","","$5.00 USD",5,-0.52,4.48,7392.2,"USD","hledger","hledger","markus-schmitz","Markus Schmitz","STRIPE","CREDITCARD",,"",,,
"2023-07-02T13:07:37","6025e8a0","4bbd99fc","Host Fee to Open Source Collective","DEBIT","HOST_FEE","","","","-$0.50 USD",-0.5,0,-0.5,7387.72,"USD","hledger","hledger","opensource","Open Source Collective",,,,"",,,
"2023-07-02T00:05:34","0d96d25f","c0a38e98","Monthly contribution from Aviator Game (Individuals)","CREDIT","CONTRIBUTION","","","","$5.00 USD",5,-0.52,4.48,7388.22,"USD","hledger","hledger","aviator-game1","Aviator Game","STRIPE","CREDITCARD",,"",,,
"2023-07-02T00:05:34","110faddc","c0a38e98","Host Fee to Open Source Collective","DEBIT","HOST_FEE","","","","-$0.50 USD",-0.5,0,-0.5,7383.74,"USD","hledger","hledger","opensource","Open Source Collective",,,,"",,,
"2023-07-01T14:03:17","e73368c7","ea801ac5","Monthly contribution from Brandon J Wong (Individuals)","CREDIT","CONTRIBUTION","","","","$2.00 USD",2,-0.39,1.61,7384.24,"USD","hledger","hledger","brandon-j-wong","Brandon J Wong",,,,"",,,
"2023-07-01T14:03:17","74b767f2","ea801ac5","Host Fee to Open Source Collective","DEBIT","HOST_FEE","","","","-$0.20 USD",-0.2,0,-0.2,7382.63,"USD","hledger","hledger","opensource","Open Source Collective",,,,"",,,
"2023-07-01T13:06:44","31cf08d0","2743b8c0","Monthly contribution from Frank (Individuals)","CREDIT","CONTRIBUTION","","","","$2.00 USD",2,-0.36,1.64,7382.83,"USD","hledger","hledger","guest-4c0726ae","Frank","STRIPE","CREDITCARD",,"",,,
"2023-07-01T13:06:44","44ad2776","2743b8c0","Host Fee to Open Source Collective","DEBIT","HOST_FEE","","","","-$0.20 USD",-0.2,0,-0.2,7381.19,"USD","hledger","hledger","opensource","Open Source Collective",,,,"",,,
"2023-07-01T12:04:45","158b61c4","a8c5ef2f","Monthly contribution from James Blachly (Individuals)","CREDIT","CONTRIBUTION","","","","$2.00 USD",2,-0.36,1.64,7381.39,"USD","hledger","hledger","james-blachly","James Blachly","STRIPE","CREDITCARD",,"",,,
"2023-07-01T12:04:45","1ecfc980","a8c5ef2f","Host Fee to Open Source Collective","DEBIT","HOST_FEE","","","","-$0.20 USD",-0.2,0,-0.2,7379.75,"USD","hledger","hledger","opensource","Open Source Collective",,,,"",,,
"2023-07-01T11:04:35","a83bffd7","be8afdb9","Monthly contribution from Ken Ewing (Individuals)","CREDIT","CONTRIBUTION","","","","$2.00 USD",2,-0.36,1.64,7379.95,"USD","hledger","hledger","ken-ewing","Ken Ewing","STRIPE","CREDITCARD",,"",,,
"2023-07-01T11:04:35","f891ef78","be8afdb9","Host Fee to Open Source Collective","DEBIT","HOST_FEE","","","","-$0.20 USD",-0.2,0,-0.2,7378.31,"USD","hledger","hledger","opensource","Open Source Collective",,,,"",,,
"2023-07-01T03:08:03","a36c8fe8","9d5f2af6","Monthly contribution from Jack Todaro (Individuals)","CREDIT","CONTRIBUTION","","","","$2.00 USD",2,-0.39,1.61,7378.51,"USD","hledger","hledger","jack-todaro","Jack Todaro","STRIPE","CREDITCARD",,"",,,
"2023-07-01T03:08:03","98e2d879","9d5f2af6","Host Fee to Open Source Collective","DEBIT","HOST_FEE","","","","-$0.20 USD",-0.2,0,-0.2,7376.9,"USD","hledger","hledger","opensource","Open Source Collective",,,,"",,,
"2023-07-01T01:09:06","7d78b5b4","ce949467","Monthly contribution from October Swimmer (Organisations)","CREDIT","CONTRIBUTION","","","","$100.00 USD",100,-3.2,96.8,7377.1,"USD","hledger","hledger","october-swimmer","October Swimmer",,,,"",,,
"2023-07-01T01:09:06","535368a8","ce949467","Host Fee to Open Source Collective","DEBIT","HOST_FEE","","","","-$10.00 USD",-10,0,-10,7280.3,"USD","hledger","hledger","opensource","Open Source Collective",,,,"",,,
"2023-07-01T00:08:16","114f6b1c","883b2821","Monthly contribution from Brandon Barker (Individuals)","CREDIT","CONTRIBUTION","","","","$2.00 USD",2,-0.36,1.64,7290.3,"USD","hledger","hledger","brandonbarker","Brandon Barker","STRIPE","CREDITCARD",,"",,,
"2023-07-01T00:08:16","dbf95d8e","883b2821","Host Fee to Open Source Collective","DEBIT","HOST_FEE","","","","-$0.20 USD",-0.2,0,-0.2,7288.66,"USD","hledger","hledger","opensource","Open Source Collective",,,,"",,,
"2023-07-01T00:06:56","5e76bfbf","20030bb4","Monthly contribution from Rishi Hyanki (Individuals)","CREDIT","CONTRIBUTION","","","","$2.00 USD",2,-0.36,1.64,7288.86,"USD","hledger","hledger","rhyanki","Rishi Hyanki","STRIPE","CREDITCARD",,"",,,
"2023-07-01T00:06:55","c9356190","20030bb4","Host Fee to Open Source Collective","DEBIT","HOST_FEE","","","","-$0.20 USD",-0.2,0,-0.2,7287.22,"USD","hledger","hledger","opensource","Open Source Collective",,,,"",,,
"2023-06-30T10:30:37","229977e9","ba1aff28","Monthly contribution from Richard Kelly (Individuals)","CREDIT","CONTRIBUTION","","","","$2.00 USD",2,-0.56,1.44,7287.42,"USD","hledger","hledger","richard-kelly","Richard Kelly","PAYPAL","SUBSCRIPTION",,"",,,
"2023-06-30T10:30:37","b85edee7","ba1aff28","Host Fee to Open Source Collective","DEBIT","HOST_FEE","","","","-$0.20 USD",-0.2,0,-0.2,7285.98,"USD","hledger","hledger","opensource","Open Source Collective",,,,"",,,
"2023-06-27T08:24:21","b18d95b8","e49eb6b2","Contribution from Incognito","CREDIT","CONTRIBUTION","","","","$20.00 USD",20,-1.49,18.51,7286.18,"USD","hledger","hledger","user-7115e1d5","Incognito","PAYPAL","PAYMENT",,"",,,
"2023-06-27T08:24:21","50a2d594","e49eb6b2","Host Fee to Open Source Collective","DEBIT","HOST_FEE","","","","-$2.00 USD",-2,0,-2,7267.67,"USD","hledger","hledger","opensource","Open Source Collective",,,,"",,,
"2023-06-24T11:07:26","8535c37f","7ff74fe3","Monthly contribution from Olsens Revision ApS (Individuals)","CREDIT","CONTRIBUTION","","","","$25.00 USD",25,-1.74,23.26,7269.67,"USD","hledger","hledger","olsensrevision","Olsens Revision ApS","PAYPAL","SUBSCRIPTION",,"",,,
"2023-06-24T11:07:26","b968670e","7ff74fe3","Host Fee to Open Source Collective","DEBIT","HOST_FEE","","","","-$2.50 USD",-2.5,0,-2.5,7246.41,"USD","hledger","hledger","opensource","Open Source Collective",,,,"",,,
"2023-06-23T10:51:56","a083078c","6f6a56a6","Monthly contribution from Guest (Individuals)","CREDIT","CONTRIBUTION","","","","$2.00 USD",2,-0.59,1.41,7248.91,"USD","hledger","hledger","guest-d120c27f","Guest","PAYPAL","SUBSCRIPTION",,"",,,
"2023-06-23T10:51:56","ebfbd3a6","6f6a56a6","Host Fee to Open Source Collective","DEBIT","HOST_FEE","","","","-$0.20 USD",-0.2,0,-0.2,7247.5,"USD","hledger","hledger","opensource","Open Source Collective",,,,"",,,
"2023-06-02T14:06:43","6d52dd8b","e969b4d9","Monthly contribution from Markus Schmitz (Individuals)","CREDIT","CONTRIBUTION","","","","$5.00 USD",5,-0.52,4.48,7247.7,"USD","hledger","hledger","markus-schmitz","Markus Schmitz","STRIPE","CREDITCARD",,"",,,
"2023-06-02T14:06:43","c226bc3b","e969b4d9","Host Fee to Open Source Collective","DEBIT","HOST_FEE","","","","-$0.50 USD",-0.5,0,-0.5,7243.22,"USD","hledger","hledger","opensource","Open Source Collective",,,,"",,,
"2023-06-02T03:08:43","41e5018b","e6ce8b6e","Monthly contribution from Aviator Game (Individuals)","CREDIT","CONTRIBUTION","","","","$5.00 USD",5,-0.52,4.48,7243.72,"USD","hledger","hledger","aviator-game1","Aviator Game","STRIPE","CREDITCARD",,"",,,
"2023-06-02T03:08:43","b3540ba4","e6ce8b6e","Host Fee to Open Source Collective","DEBIT","HOST_FEE","","","","-$0.50 USD",-0.5,0,-0.5,7239.24,"USD","hledger","hledger","opensource","Open Source Collective",,,,"",,,
"2023-06-01T16:09:26","84ca1767","b694b232","Monthly contribution from Frank (Individuals)","CREDIT","CONTRIBUTION","","","","$2.00 USD",2,-0.36,1.64,7239.74,"USD","hledger","hledger","guest-4c0726ae","Frank","STRIPE","CREDITCARD",,"",,,
"2023-06-01T16:09:26","97b38ca0","b694b232","Host Fee to Open Source Collective","DEBIT","HOST_FEE","","","","-$0.20 USD",-0.2,0,-0.2,7238.1,"USD","hledger","hledger","opensource","Open Source Collective",,,,"",,,
"2023-06-01T15:01:41","54f4532b","68e1244d","Monthly contribution from Ken Ewing (Individuals)","CREDIT","CONTRIBUTION","","","","$2.00 USD",2,-0.36,1.64,7238.3,"USD","hledger","hledger","ken-ewing","Ken Ewing","STRIPE","CREDITCARD",,"",,,
"2023-06-01T15:01:41","43fef804","68e1244d","Host Fee to Open Source Collective","DEBIT","HOST_FEE","","","","-$0.20 USD",-0.2,0,-0.2,7236.66,"USD","hledger","hledger","opensource","Open Source Collective",,,,"",,,
"2023-06-01T12:05:38","cd10a441","1271a7a7","Monthly contribution from Brandon J Wong (Individuals)","CREDIT","CONTRIBUTION","","","","$2.00 USD",2,-0.38,1.62,7236.86,"USD","hledger","hledger","brandon-j-wong","Brandon J Wong",,,,"",,,
"2023-06-01T12:05:38","115e54e5","1271a7a7","Host Fee to Open Source Collective","DEBIT","HOST_FEE","","","","-$0.20 USD",-0.2,0,-0.2,7235.24,"USD","hledger","hledger","opensource","Open Source Collective",,,,"",,,
"2023-06-01T10:07:07","de70e5e4","a98c61c5","Monthly contribution from James Blachly (Individuals)","CREDIT","CONTRIBUTION","","","","$2.00 USD",2,-0.36,1.64,7235.44,"USD","hledger","hledger","james-blachly","James Blachly","STRIPE","CREDITCARD",,"",,,
"2023-06-01T10:07:07","f6cd707d","a98c61c5","Host Fee to Open Source Collective","DEBIT","HOST_FEE","","","","-$0.20 USD",-0.2,0,-0.2,7233.8,"USD","hledger","hledger","opensource","Open Source Collective",,,,"",,,
"2023-06-01T05:02:37","7a22da21","81cdf428","Monthly contribution from Jack Todaro (Individuals)","CREDIT","CONTRIBUTION","","","","$2.00 USD",2,-0.38,1.62,7234,"USD","hledger","hledger","jack-todaro","Jack Todaro","STRIPE","CREDITCARD",,"",,,
"2023-06-01T05:02:37","b4551e1f","81cdf428","Host Fee to Open Source Collective","DEBIT","HOST_FEE","","","","-$0.20 USD",-0.2,0,-0.2,7232.38,"USD","hledger","hledger","opensource","Open Source Collective",,,,"",,,
"2023-06-01T03:04:10","eca0b9ac","4181e7e1","Monthly contribution from October Swimmer (Organisations)","CREDIT","CONTRIBUTION","","","","$100.00 USD",100,-3.2,96.8,7232.58,"USD","hledger","hledger","october-swimmer","October Swimmer",,,,"",,,
"2023-06-01T03:04:10","d9106d3c","4181e7e1","Host Fee to Open Source Collective","DEBIT","HOST_FEE","","","","-$10.00 USD",-10,0,-10,7135.78,"USD","hledger","hledger","opensource","Open Source Collective",,,,"",,,
"2023-06-01T02:08:52","87525691","d01e9668","Monthly contribution from Brandon Barker (Individuals)","CREDIT","CONTRIBUTION","","","","$2.00 USD",2,-0.36,1.64,7145.78,"USD","hledger","hledger","brandonbarker","Brandon Barker","STRIPE","CREDITCARD",,"",,,
"2023-06-01T02:08:52","b4a20e0c","d01e9668","Host Fee to Open Source Collective","DEBIT","HOST_FEE","","","","-$0.20 USD",-0.2,0,-0.2,7144.14,"USD","hledger","hledger","opensource","Open Source Collective",,,,"",,,
"2023-06-01T02:03:22","bd4eccf7","a1b25e12","Monthly contribution from Rishi Hyanki (Individuals)","CREDIT","CONTRIBUTION","","","","$2.00 USD",2,-0.36,1.64,7144.34,"USD","hledger","hledger","rhyanki","Rishi Hyanki","STRIPE","CREDITCARD",,"",,,
"2023-06-01T02:03:22","56b662ed","a1b25e12","Host Fee to Open Source Collective","DEBIT","HOST_FEE","","","","-$0.20 USD",-0.2,0,-0.2,7142.7,"USD","hledger","hledger","opensource","Open Source Collective",,,,"",,,
"2023-05-31T10:33:49","f92227dd","ed7cd1c9","Monthly contribution from Richard Kelly (Individuals)","CREDIT","CONTRIBUTION","","","","$2.00 USD",2,-0.56,1.44,7142.9,"USD","hledger","hledger","richard-kelly","Richard Kelly","PAYPAL","SUBSCRIPTION",,"",,,
"2023-05-31T10:33:48","4ff30713","ed7cd1c9","Host Fee to Open Source Collective","DEBIT","HOST_FEE","","","","-$0.20 USD",-0.2,0,-0.2,7141.46,"USD","hledger","hledger","opensource","Open Source Collective",,,,"",,,
"2023-05-24T11:33:13","ac6fc645","4df278ed","Monthly contribution from Olsens Revision ApS (Individuals)","CREDIT","CONTRIBUTION","","","","$25.00 USD",25,-1.74,23.26,7141.66,"USD","hledger","hledger","olsensrevision","Olsens Revision ApS","PAYPAL","SUBSCRIPTION",,"",,,
"2023-05-24T11:33:12","c856e53b","4df278ed","Host Fee to Open Source Collective","DEBIT","HOST_FEE","","","","-$2.50 USD",-2.5,0,-2.5,7118.4,"USD","hledger","hledger","opensource","Open Source Collective",,,,"",,,
"2023-05-23T10:50:47","e5aaf38d","8a62c399","Monthly contribution from Guest (Individuals)","CREDIT","CONTRIBUTION","","","","$2.00 USD",2,-0.59,1.41,7120.9,"USD","hledger","hledger","guest-d120c27f","Guest","PAYPAL","SUBSCRIPTION",,"",,,
"2023-05-23T10:50:47","e8ddf71e","8a62c399","Host Fee to Open Source Collective","DEBIT","HOST_FEE","","","","-$0.20 USD",-0.2,0,-0.2,7119.49,"USD","hledger","hledger","opensource","Open Source Collective",,,,"",,,
"2023-05-04T17:01:12","2e10b761","9df5d5f4","Expense from Simon Michael - Regression bounty for #2032","DEBIT","EXPENSE","","","","-$100.00 USD",-100,-0.25,-100.25,7119.69,"USD","hledger","hledger","simon","Simon Michael",,,"INVOICE","","PAYPAL",,
"2023-05-02T16:07:05","287810d6","c830dc79","Monthly contribution from Markus Schmitz (Individuals)","CREDIT","CONTRIBUTION","","","","$5.00 USD",5,-0.5,4.5,7219.94,"USD","hledger","hledger","markus-schmitz","Markus Schmitz","STRIPE","CREDITCARD",,"",,,
"2023-05-02T16:07:04","915f35b0","c830dc79","Host Fee to Open Source Collective","DEBIT","HOST_FEE","","","","-$0.50 USD",-0.5,0,-0.5,7215.44,"USD","hledger","hledger","opensource","Open Source Collective",,,,"",,,
"2023-05-02T05:11:44","516dd80a","2ceddec2","Monthly contribution from Aviator Game (Individuals)","CREDIT","CONTRIBUTION","","","","$5.00 USD",5,-0.5,4.5,7215.94,"USD","hledger","hledger","aviator-game1","Aviator Game","STRIPE","CREDITCARD",,"",,,
"2023-05-02T05:11:44","be581547","2ceddec2","Host Fee to Open Source Collective","DEBIT","HOST_FEE","","","","-$0.50 USD",-0.5,0,-0.5,7211.44,"USD","hledger","hledger","opensource","Open Source Collective",,,,"",,,
"2023-05-01T15:09:19","9e45ce0d","b7e6f8ad","Monthly contribution from Frank (Individuals)","CREDIT","CONTRIBUTION","","","","$2.00 USD",2,-0.36,1.64,7211.94,"USD","hledger","hledger","guest-4c0726ae","Frank","STRIPE","CREDITCARD",,"",,,
"2023-05-01T15:09:19","66bb5723","b7e6f8ad","Host Fee to Open Source Collective","DEBIT","HOST_FEE","","","","-$0.20 USD",-0.2,0,-0.2,7210.3,"USD","hledger","hledger","opensource","Open Source Collective",,,,"",,,
"2023-05-01T13:13:01","5976b351","f470d18e","Monthly contribution from Ken Ewing (Individuals)","CREDIT","CONTRIBUTION","","","","$2.00 USD",2,-0.36,1.64,7210.5,"USD","hledger","hledger","ken-ewing","Ken Ewing","STRIPE","CREDITCARD",,"",,,
"2023-05-01T13:13:00","be3901bb","f470d18e","Host Fee to Open Source Collective","DEBIT","HOST_FEE","","","","-$0.20 USD",-0.2,0,-0.2,7208.86,"USD","hledger","hledger","opensource","Open Source Collective",,,,"",,,
"2023-05-01T10:14:02","7176e580","1a223fc6","Monthly contribution from Brandon J Wong (Individuals)","CREDIT","CONTRIBUTION","","","","$2.00 USD",2,-0.38,1.62,7209.06,"USD","hledger","hledger","brandon-j-wong","Brandon J Wong",,,,"",,,
"2023-05-01T10:14:02","aa704f38","1a223fc6","Host Fee to Open Source Collective","DEBIT","HOST_FEE","","","","-$0.20 USD",-0.2,0,-0.2,7207.44,"USD","hledger","hledger","opensource","Open Source Collective",,,,"",,,
"2023-05-01T08:12:28","5cc49c3e","ffc57ce9","Monthly contribution from James Blachly (Individuals)","CREDIT","CONTRIBUTION","","","","$2.00 USD",2,-0.36,1.64,7207.64,"USD","hledger","hledger","james-blachly","James Blachly","STRIPE","CREDITCARD",,"",,,
"2023-05-01T08:12:28","e59361c7","ffc57ce9","Host Fee to Open Source Collective","DEBIT","HOST_FEE","","","","-$0.20 USD",-0.2,0,-0.2,7206,"USD","hledger","hledger","opensource","Open Source Collective",,,,"",,,
"2023-05-01T03:12:50","e5e50c8b","a6ad4e5f","Monthly contribution from Jack Todaro (Individuals)","CREDIT","CONTRIBUTION","","","","$2.00 USD",2,-0.38,1.62,7206.2,"USD","hledger","hledger","jack-todaro","Jack Todaro","STRIPE","CREDITCARD",,"",,,
"2023-05-01T03:12:49","8f050cde","a6ad4e5f","Host Fee to Open Source Collective","DEBIT","HOST_FEE","","","","-$0.20 USD",-0.2,0,-0.2,7204.58,"USD","hledger","hledger","opensource","Open Source Collective",,,,"",,,
"2023-05-01T03:06:00","b252868f","510a59fb","Monthly contribution from October Swimmer (Organisations)","CREDIT","CONTRIBUTION","","","","$100.00 USD",100,-3.2,96.8,7204.78,"USD","hledger","hledger","october-swimmer","October Swimmer",,,,"",,,
"2023-05-01T03:06:00","7c1a5beb","510a59fb","Host Fee to Open Source Collective","DEBIT","HOST_FEE","","","","-$10.00 USD",-10,0,-10,7107.98,"USD","hledger","hledger","opensource","Open Source Collective",,,,"",,,
"2023-05-01T02:14:37","10464be5","f93925e7","Monthly contribution from Brandon Barker (Individuals)","CREDIT","CONTRIBUTION","","","","$2.00 USD",2,-0.36,1.64,7117.98,"USD","hledger","hledger","brandonbarker","Brandon Barker","STRIPE","CREDITCARD",,"",,,
"2023-05-01T02:14:37","5ec2790c","f93925e7","Host Fee to Open Source Collective","DEBIT","HOST_FEE","","","","-$0.20 USD",-0.2,0,-0.2,7116.34,"USD","hledger","hledger","opensource","Open Source Collective",,,,"",,,
"2023-05-01T02:06:55","5df18d18","5708a912","Monthly contribution from Rishi Hyanki (Individuals)","CREDIT","CONTRIBUTION","","","","$2.00 USD",2,-0.36,1.64,7116.54,"USD","hledger","hledger","rhyanki","Rishi Hyanki","STRIPE","CREDITCARD",,"",,,
"2023-05-01T02:06:54","3d3e9062","5708a912","Host Fee to Open Source Collective","DEBIT","HOST_FEE","","","","-$0.20 USD",-0.2,0,-0.2,7114.9,"USD","hledger","hledger","opensource","Open Source Collective",,,,"",,,
"2023-04-30T10:34:58","bc2c5dd3","90fb4fca","Monthly contribution from Richard Kelly (Individuals)","CREDIT","CONTRIBUTION","","","","$2.00 USD",2,-0.56,1.44,7115.1,"USD","hledger","hledger","richard-kelly","Richard Kelly","PAYPAL","SUBSCRIPTION",,"",,,
"2023-04-30T10:34:58","8477780a","90fb4fca","Host Fee to Open Source Collective","DEBIT","HOST_FEE","","","","-$0.20 USD",-0.2,0,-0.2,7113.66,"USD","hledger","hledger","opensource","Open Source Collective",,,,"",,,
"2023-04-24T11:05:55","ee4cfa2d","94eea667","Monthly contribution from Olsens Revision ApS (Individuals)","CREDIT","CONTRIBUTION","","","","$25.00 USD",25,-1.74,23.26,7113.86,"USD","hledger","hledger","olsensrevision","Olsens Revision ApS","PAYPAL","SUBSCRIPTION",,"",,,
"2023-04-24T11:05:55","12ca4b9d","94eea667","Host Fee to Open Source Collective","DEBIT","HOST_FEE","","","","-$2.50 USD",-2.5,0,-2.5,7090.6,"USD","hledger","hledger","opensource","Open Source Collective",,,,"",,,
"2023-04-23T10:55:49","b80e21b6","60edf87b","Monthly contribution from Guest (Individuals)","CREDIT","CONTRIBUTION","","","","$2.00 USD",2,-0.59,1.41,7093.1,"USD","hledger","hledger","guest-d120c27f","Guest","PAYPAL","SUBSCRIPTION",,"",,,
"2023-04-23T10:55:49","a8954783","60edf87b","Host Fee to Open Source Collective","DEBIT","HOST_FEE","","","","-$0.20 USD",-0.2,0,-0.2,7091.69,"USD","hledger","hledger","opensource","Open Source Collective",,,,"",,,
"2023-04-13T19:02:44","49dd2020","f8bf3d65","Expense from Simon Michael - Regression bounty for #2023","DEBIT","EXPENSE","","","","-$100.00 USD",-100,-0.25,-100.25,7091.89,"USD","hledger","hledger","simon","Simon Michael",,,"INVOICE","","PAYPAL",,
"2023-04-04T17:03:56","66c37ff0","19b2e9bd","Expense from pablo - regression bounty","DEBIT","EXPENSE","","","","-$100.00 USD",-100,-2,-102,7192.14,"USD","hledger","hledger","pablo6","pablo",,,"INVOICE","","PAYPAL",,
"2023-04-02T15:09:59","3d702bf3","c241a434","Monthly contribution from Markus Schmitz (Individuals)","CREDIT","CONTRIBUTION","","","","$5.00 USD",5,-0.5,4.5,7294.14,"USD","hledger","hledger","markus-schmitz","Markus Schmitz","STRIPE","CREDITCARD",,"",,,
"2023-04-02T15:09:58","00c25043","c241a434","Host Fee to Open Source Collective","DEBIT","HOST_FEE","","","","-$0.50 USD",-0.5,0,-0.5,7289.64,"USD","hledger","hledger","opensource","Open Source Collective",,,,"",,,
"2023-04-02T05:14:47","5a121532","1a4b9d8f","Monthly contribution from Aviator Game (Individuals)","CREDIT","CONTRIBUTION","","","","$5.00 USD",5,-0.5,4.5,7290.14,"USD","hledger","hledger","aviator-game1","Aviator Game","STRIPE","CREDITCARD",,"",,,
"2023-04-02T05:14:46","5a9598c3","1a4b9d8f","Host Fee to Open Source Collective","DEBIT","HOST_FEE","","","","-$0.50 USD",-0.5,0,-0.5,7285.64,"USD","hledger","hledger","opensource","Open Source Collective",,,,"",,,
"2023-04-01T17:08:12","49cf9d01","32bf9d2c","Monthly contribution from Frank (Individuals)","CREDIT","CONTRIBUTION","","","","$2.00 USD",2,-0.36,1.64,7286.14,"USD","hledger","hledger","guest-4c0726ae","Frank","STRIPE","CREDITCARD",,"",,,
"2023-04-01T17:08:12","b9a991fd","32bf9d2c","Host Fee to Open Source Collective","DEBIT","HOST_FEE","","","","-$0.20 USD",-0.2,0,-0.2,7284.5,"USD","hledger","hledger","opensource","Open Source Collective",,,,"",,,
"2023-04-01T15:05:11","1e089c55","618d6318","Monthly contribution from Brandon J Wong (Individuals)","CREDIT","CONTRIBUTION","","","","$2.00 USD",2,-0.38,1.62,7284.7,"USD","hledger","hledger","brandon-j-wong","Brandon J Wong",,,,"",,,
"2023-04-01T15:05:11","3d4f4991","618d6318","Host Fee to Open Source Collective","DEBIT","HOST_FEE","","","","-$0.20 USD",-0.2,0,-0.2,7283.08,"USD","hledger","hledger","opensource","Open Source Collective",,,,"",,,
"2023-04-01T14:13:16","6f2c1495","47b920dd","Monthly contribution from Ken Ewing (Individuals)","CREDIT","CONTRIBUTION","","","","$2.00 USD",2,-0.36,1.64,7283.28,"USD","hledger","hledger","ken-ewing","Ken Ewing","STRIPE","CREDITCARD",,"",,,
"2023-04-01T14:13:15","24aff795","47b920dd","Host Fee to Open Source Collective","DEBIT","HOST_FEE","","","","-$0.20 USD",-0.2,0,-0.2,7281.64,"USD","hledger","hledger","opensource","Open Source Collective",,,,"",,,
"2023-04-01T10:11:29","99d91b25","c44501bf","Monthly contribution from James Blachly (Individuals)","CREDIT","CONTRIBUTION","","","","$2.00 USD",2,-0.36,1.64,7281.84,"USD","hledger","hledger","james-blachly","James Blachly","STRIPE","CREDITCARD",,"",,,
"2023-04-01T10:11:29","9bd3c7b4","c44501bf","Host Fee to Open Source Collective","DEBIT","HOST_FEE","","","","-$0.20 USD",-0.2,0,-0.2,7280.2,"USD","hledger","hledger","opensource","Open Source Collective",,,,"",,,
"2023-04-01T04:08:11","a6afd59f","4d2fed9c","Monthly contribution from Rishi Hyanki (Individuals)","CREDIT","CONTRIBUTION","","","","$2.00 USD",2,-0.36,1.64,7280.4,"USD","hledger","hledger","rhyanki","Rishi Hyanki","STRIPE","CREDITCARD",,"",,,
"2023-04-01T04:08:11","4970611d","4d2fed9c","Host Fee to Open Source Collective","DEBIT","HOST_FEE","","","","-$0.20 USD",-0.2,0,-0.2,7278.76,"USD","hledger","hledger","opensource","Open Source Collective",,,,"",,,
"2023-04-01T03:15:22","ccdedcfc","0a4aee9b","Monthly contribution from Jack Todaro (Individuals)","CREDIT","CONTRIBUTION","","","","$2.00 USD",2,-0.38,1.62,7278.96,"USD","hledger","hledger","jack-todaro","Jack Todaro","STRIPE","CREDITCARD",,"",,,
"2023-04-01T03:15:22","b6d55e51","0a4aee9b","Host Fee to Open Source Collective","DEBIT","HOST_FEE","","","","-$0.20 USD",-0.2,0,-0.2,7277.34,"USD","hledger","hledger","opensource","Open Source Collective",,,,"",,,
"2023-04-01T02:12:32","83f882c8","1d6f569b","Monthly contribution from Brandon Barker (Individuals)","CREDIT","CONTRIBUTION","","","","$2.00 USD",2,-0.36,1.64,7277.54,"USD","hledger","hledger","brandonbarker","Brandon Barker","STRIPE","CREDITCARD",,"",,,
"2023-04-01T02:12:31","4fa8b482","1d6f569b","Host Fee to Open Source Collective","DEBIT","HOST_FEE","","","","-$0.20 USD",-0.2,0,-0.2,7275.9,"USD","hledger","hledger","opensource","Open Source Collective",,,,"",,,
"2023-04-01T01:19:23","27c80326","1f5498ef","Monthly contribution from October Swimmer (Organisations)","CREDIT","CONTRIBUTION","","","","$100.00 USD",100,-3.2,96.8,7276.1,"USD","hledger","hledger","october-swimmer","October Swimmer",,,,"",,,
"2023-04-01T01:19:21","01d95ca8","1f5498ef","Host Fee to Open Source Collective","DEBIT","HOST_FEE","","","","-$10.00 USD",-10,0,-10,7179.3,"USD","hledger","hledger","opensource","Open Source Collective",,,,"",,,
"2023-04-01T00:16:27","e47f06c8","fca26a0f","Monthly contribution from Michael Martinides (Individuals)","CREDIT","CONTRIBUTION","","","","$2.00 USD",2,-0.38,1.62,7189.3,"USD","hledger","hledger","michael-martinides","Michael Martinides","STRIPE","CREDITCARD",,"",,,
"2023-04-01T00:16:27","84ecab79","fca26a0f","Host Fee to Open Source Collective","DEBIT","HOST_FEE","","","","-$0.20 USD",-0.2,0,-0.2,7187.68,"USD","hledger","hledger","opensource","Open Source Collective",,,,"",,,
"2023-03-31T10:26:44","1e10b3d4","88cf6bd0","Monthly contribution from Richard Kelly (Individuals)","CREDIT","CONTRIBUTION","","","","$2.00 USD",2,-0.56,1.44,7187.88,"USD","hledger","hledger","richard-kelly","Richard Kelly","PAYPAL","SUBSCRIPTION",,"",,,
"2023-03-31T10:26:44","c83b4820","88cf6bd0","Host Fee to Open Source Collective","DEBIT","HOST_FEE","","","","-$0.20 USD",-0.2,0,-0.2,7186.44,"USD","hledger","hledger","opensource","Open Source Collective",,,,"",,,
"2023-03-28T20:21:19","ea535d0e","e0f0e54a","Expense from Allan Odgaard - regression bounty","DEBIT","EXPENSE","","","","-$100.00 USD",-100,-0.39,-100.39,7186.64,"USD","hledger","hledger","allan-odgaard","Allan Odgaard",,,"INVOICE","","BANK_ACCOUNT",,
"2023-03-24T10:49:42","6a3d14d7","ea8e992e","Monthly contribution from Olsens Revision ApS (Individuals)","CREDIT","CONTRIBUTION","","","","$25.00 USD",25,-1.74,23.26,7287.03,"USD","hledger","hledger","olsensrevision","Olsens Revision ApS","PAYPAL","SUBSCRIPTION",,"",,,
"2023-03-24T10:49:42","526ebb29","ea8e992e","Host Fee to Open Source Collective","DEBIT","HOST_FEE","","","","-$2.50 USD",-2.5,0,-2.5,7263.77,"USD","hledger","hledger","opensource","Open Source Collective",,,,"",,,
"2023-03-23T10:39:58","a57e6cad","5462b648","Monthly contribution from Guest (Individuals)","CREDIT","CONTRIBUTION","","","","$2.00 USD",2,-0.59,1.41,7266.27,"USD","hledger","hledger","guest-d120c27f","Guest","PAYPAL","SUBSCRIPTION",,"",,,
"2023-03-23T10:39:58","ac32041b","5462b648","Host Fee to Open Source Collective","DEBIT","HOST_FEE","","","","-$0.20 USD",-0.2,0,-0.2,7264.86,"USD","hledger","hledger","opensource","Open Source Collective",,,,"",,,
"2023-03-05T14:09:46","5e2e43a5","dd69e983","Monthly contribution from Markus Schmitz (Individuals)","CREDIT","CONTRIBUTION","","","","$5.00 USD",5,-0.5,4.5,7265.06,"USD","hledger","hledger","markus-schmitz","Markus Schmitz","STRIPE","CREDITCARD",,"",,,
"2023-03-05T14:09:46","4ee42f5c","dd69e983","Host Fee to Open Source Collective","DEBIT","HOST_FEE","","","","-$0.50 USD",-0.5,0,-0.5,7260.56,"USD","hledger","hledger","opensource","Open Source Collective",,,,"",,,
"2023-03-02T07:15:14","d96e9f5d","6ae9e561","Monthly contribution from Aviator Game (Individuals)","CREDIT","CONTRIBUTION","","","","$5.00 USD",5,-0.5,4.5,7261.06,"USD","hledger","hledger","aviator-game1","Aviator Game","STRIPE","CREDITCARD",,"",,,
"2023-03-02T07:15:13","6cdefde9","6ae9e561","Host Fee to Open Source Collective","DEBIT","HOST_FEE","","","","-$0.50 USD",-0.5,0,-0.5,7256.56,"USD","hledger","hledger","opensource","Open Source Collective",,,,"",,,
"2023-03-01T18:21:55","9272af8f","f735b016","Monthly contribution from Frank (Individuals)","CREDIT","CONTRIBUTION","","","","$2.00 USD",2,-0.36,1.64,7257.06,"USD","hledger","hledger","guest-4c0726ae","Frank","STRIPE","CREDITCARD",,"",,,
"2023-03-01T18:21:55","3d868d7d","f735b016","Host Fee to Open Source Collective","DEBIT","HOST_FEE","","","","-$0.20 USD",-0.2,0,-0.2,7255.42,"USD","hledger","hledger","opensource","Open Source Collective",,,,"",,,
"2023-03-01T16:17:38","77de02b0","76548d5c","Monthly contribution from Ken Ewing (Individuals)","CREDIT","CONTRIBUTION","","","","$2.00 USD",2,-0.36,1.64,7255.62,"USD","hledger","hledger","ken-ewing","Ken Ewing","STRIPE","CREDITCARD",,"",,,
"2023-03-01T16:17:38","a95b2b77","76548d5c","Host Fee to Open Source Collective","DEBIT","HOST_FEE","","","","-$0.20 USD",-0.2,0,-0.2,7253.98,"USD","hledger","hledger","opensource","Open Source Collective",,,,"",,,
"2023-03-01T13:23:56","6a9ea4f6","2f76e99e","Monthly contribution from Brandon J Wong (Individuals)","CREDIT","CONTRIBUTION","","","","$2.00 USD",2,-0.38,1.62,7254.18,"USD","hledger","hledger","brandon-j-wong","Brandon J Wong",,,,"",,,
"2023-03-01T13:23:56","8eae9c92","2f76e99e","Host Fee to Open Source Collective","DEBIT","HOST_FEE","","","","-$0.20 USD",-0.2,0,-0.2,7252.56,"USD","hledger","hledger","opensource","Open Source Collective",,,,"",,,
"2023-03-01T11:21:01","cae3ffe1","c6a62ec4","Monthly contribution from James Blachly (Individuals)","CREDIT","CONTRIBUTION","","","","$2.00 USD",2,-0.36,1.64,7252.76,"USD","hledger","hledger","james-blachly","James Blachly","STRIPE","CREDITCARD",,"",,,
"2023-03-01T11:21:01","d3ddad65","c6a62ec4","Host Fee to Open Source Collective","DEBIT","HOST_FEE","","","","-$0.20 USD",-0.2,0,-0.2,7251.12,"USD","hledger","hledger","opensource","Open Source Collective",,,,"",,,
"2023-03-01T05:18:22","e9e330ee","db3d3adf","Monthly contribution from Jack Todaro (Individuals)","CREDIT","CONTRIBUTION","","","","$2.00 USD",2,-0.38,1.62,7251.32,"USD","hledger","hledger","jack-todaro","Jack Todaro","STRIPE","CREDITCARD",,"",,,
"2023-03-01T05:18:22","3ed7be79","db3d3adf","Host Fee to Open Source Collective","DEBIT","HOST_FEE","","","","-$0.20 USD",-0.2,0,-0.2,7249.7,"USD","hledger","hledger","opensource","Open Source Collective",,,,"",,,
"2023-03-01T03:18:45","d3db64ba","af51fe46","Monthly contribution from October Swimmer (Organisations)","CREDIT","CONTRIBUTION","","","","$100.00 USD",100,-3.2,96.8,7249.9,"USD","hledger","hledger","october-swimmer","October Swimmer",,,,"",,,
"2023-03-01T03:18:45","52053dd5","af51fe46","Host Fee to Open Source Collective","DEBIT","HOST_FEE","","","","-$10.00 USD",-10,0,-10,7153.1,"USD","hledger","hledger","opensource","Open Source Collective",,,,"",,,
"2023-03-01T03:05:32","e6992105","21e02058","Monthly contribution from Brandon Barker (Individuals)","CREDIT","CONTRIBUTION","","","","$2.00 USD",2,-0.36,1.64,7163.1,"USD","hledger","hledger","brandonbarker","Brandon Barker","STRIPE","CREDITCARD",,"",,,
"2023-03-01T03:05:32","172b3636","21e02058","Host Fee to Open Source Collective","DEBIT","HOST_FEE","","","","-$0.20 USD",-0.2,0,-0.2,7161.46,"USD","hledger","hledger","opensource","Open Source Collective",,,,"",,,
"2023-03-01T02:13:30","c69d49fa","bf4e322c","Monthly contribution from Rishi Hyanki (Individuals)","CREDIT","CONTRIBUTION","","","","$2.00 USD",2,-0.36,1.64,7161.66,"USD","hledger","hledger","rhyanki","Rishi Hyanki","STRIPE","CREDITCARD",,"",,,
"2023-03-01T02:13:30","b8d21161","bf4e322c","Host Fee to Open Source Collective","DEBIT","HOST_FEE","","","","-$0.20 USD",-0.2,0,-0.2,7160.02,"USD","hledger","hledger","opensource","Open Source Collective",,,,"",,,
"2023-03-01T01:16:33","34ecf596","55b7b885","Monthly contribution from Michael Martinides (Individuals)","CREDIT","CONTRIBUTION","","","","$2.00 USD",2,-0.38,1.62,7160.22,"USD","hledger","hledger","michael-martinides","Michael Martinides","STRIPE","CREDITCARD",,"",,,
"2023-03-01T01:16:33","2f735de0","55b7b885","Host Fee to Open Source Collective","DEBIT","HOST_FEE","","","","-$0.20 USD",-0.2,0,-0.2,7158.6,"USD","hledger","hledger","opensource","Open Source Collective",,,,"",,,
"2023-02-28T12:12:41","51dae35c","37eefdbf","Monthly contribution from Richard Kelly (Individuals)","CREDIT","CONTRIBUTION","","","","$2.00 USD",2,-0.56,1.44,7158.8,"USD","hledger","hledger","richard-kelly","Richard Kelly","PAYPAL","SUBSCRIPTION",,"",,,
"2023-02-28T12:12:41","6c6d47e4","37eefdbf","Host Fee to Open Source Collective","DEBIT","HOST_FEE","","","","-$0.20 USD",-0.2,0,-0.2,7157.36,"USD","hledger","hledger","opensource","Open Source Collective",,,,"",,,
"2023-02-24T11:38:48","10245bd2","61e3e326","Monthly contribution from Olsens Revision ApS (Individuals)","CREDIT","CONTRIBUTION","","","","$25.00 USD",25,-1.74,23.26,7157.56,"USD","hledger","hledger","olsensrevision","Olsens Revision ApS","PAYPAL","SUBSCRIPTION",,"",,,
"2023-02-24T11:38:48","9a577c88","61e3e326","Host Fee to Open Source Collective","DEBIT","HOST_FEE","","","","-$2.50 USD",-2.5,0,-2.5,7134.3,"USD","hledger","hledger","opensource","Open Source Collective",,,,"",,,
"2023-02-23T11:15:08","24957d14","cd1dd6ec","Monthly contribution from Guest (Individuals)","CREDIT","CONTRIBUTION","","","","$2.00 USD",2,-0.59,1.41,7136.8,"USD","hledger","hledger","guest-d120c27f","Guest","PAYPAL","SUBSCRIPTION",,"",,,
"2023-02-23T11:15:07","e33af2be","cd1dd6ec","Host Fee to Open Source Collective","DEBIT","HOST_FEE","","","","-$0.20 USD",-0.2,0,-0.2,7135.39,"USD","hledger","hledger","opensource","Open Source Collective",,,,"",,,
"2023-02-02T08:17:42","9795c4c5","ae2d5d7b","Monthly contribution from Aviator Game (Individuals)","CREDIT","CONTRIBUTION","","","","$5.00 USD",5,-0.5,4.5,7135.59,"USD","hledger","hledger","aviator-game1","Aviator Game","STRIPE","CREDITCARD",,"",,,
"2023-02-02T08:17:42","ec0ae667","ae2d5d7b","Host Fee to Open Source Collective","DEBIT","HOST_FEE","","","","-$0.50 USD",-0.5,0,-0.5,7131.09,"USD","hledger","hledger","opensource","Open Source Collective",,,,"",,,
"2023-02-01T19:09:49","6d01b135","4aa3eddf","Monthly contribution from Frank (Individuals)","CREDIT","CONTRIBUTION","","","","$2.00 USD",2,-0.36,1.64,7131.59,"USD","hledger","hledger","guest-4c0726ae","Frank","STRIPE","CREDITCARD",,"",,,
"2023-02-01T19:09:49","8fa482af","4aa3eddf","Host Fee to Open Source Collective","DEBIT","HOST_FEE","","","","-$0.20 USD",-0.2,0,-0.2,7129.95,"USD","hledger","hledger","opensource","Open Source Collective",,,,"",,,
"2023-02-01T17:07:18","4b879b04","88fdee51","Monthly contribution from Ken Ewing (Individuals)","CREDIT","CONTRIBUTION","","","","$2.00 USD",2,-0.36,1.64,7130.15,"USD","hledger","hledger","ken-ewing","Ken Ewing","STRIPE","CREDITCARD",,"",,,
"2023-02-01T17:07:17","d3bb3392","88fdee51","Host Fee to Open Source Collective","DEBIT","HOST_FEE","","","","-$0.20 USD",-0.2,0,-0.2,7128.51,"USD","hledger","hledger","opensource","Open Source Collective",,,,"",,,
"2023-02-01T14:08:45","4bad317d","540b9f7b","Monthly contribution from Brandon J Wong (Individuals)","CREDIT","CONTRIBUTION","","","","$2.00 USD",2,-0.38,1.62,7128.71,"USD","hledger","hledger","brandon-j-wong","Brandon J Wong",,,,"",,,
"2023-02-01T14:08:44","e74d01f6","540b9f7b","Host Fee to Open Source Collective","DEBIT","HOST_FEE","","","","-$0.20 USD",-0.2,0,-0.2,7127.09,"USD","hledger","hledger","opensource","Open Source Collective",,,,"",,,
"2023-02-01T12:05:48","9c6d6607","0fc2f6c7","Monthly contribution from James Blachly (Individuals)","CREDIT","CONTRIBUTION","","","","$2.00 USD",2,-0.36,1.64,7127.29,"USD","hledger","hledger","james-blachly","James Blachly","STRIPE","CREDITCARD",,"",,,
"2023-02-01T12:05:48","96e12c39","0fc2f6c7","Host Fee to Open Source Collective","DEBIT","HOST_FEE","","","","-$0.20 USD",-0.2,0,-0.2,7125.65,"USD","hledger","hledger","opensource","Open Source Collective",,,,"",,,
"2023-02-01T05:15:32","2f4bd5ac","f11117d6","Monthly contribution from Jack Todaro (Individuals)","CREDIT","CONTRIBUTION","","","","$2.00 USD",2,-0.38,1.62,7125.85,"USD","hledger","hledger","jack-todaro","Jack Todaro","STRIPE","CREDITCARD",,"",,,
"2023-02-01T05:15:32","526e6a32","f11117d6","Host Fee to Open Source Collective","DEBIT","HOST_FEE","","","","-$0.20 USD",-0.2,0,-0.2,7124.23,"USD","hledger","hledger","opensource","Open Source Collective",,,,"",,,
"2023-02-01T03:16:32","65017ae4","f2f1831a","Monthly contribution from October Swimmer (Organisations)","CREDIT","CONTRIBUTION","","","","$100.00 USD",100,-3.2,96.8,7124.43,"USD","hledger","hledger","october-swimmer","October Swimmer",,,,"",,,
"2023-02-01T03:16:32","df0acc1f","f2f1831a","Host Fee to Open Source Collective","DEBIT","HOST_FEE","","","","-$10.00 USD",-10,0,-10,7027.63,"USD","hledger","hledger","opensource","Open Source Collective",,,,"",,,
"2023-02-01T03:04:28","4963022b","6bd07a8f","Monthly contribution from Brandon Barker (Individuals)","CREDIT","CONTRIBUTION","","","","$2.00 USD",2,-0.36,1.64,7037.63,"USD","hledger","hledger","brandonbarker","Brandon Barker","STRIPE","CREDITCARD",,"",,,
"2023-02-01T03:04:28","56975e80","6bd07a8f","Host Fee to Open Source Collective","DEBIT","HOST_FEE","","","","-$0.20 USD",-0.2,0,-0.2,7035.99,"USD","hledger","hledger","opensource","Open Source Collective",,,,"",,,
"2023-02-01T02:10:38","a4e904ab","cf2b2393","Monthly contribution from Rishi Hyanki (Individuals)","CREDIT","CONTRIBUTION","","","","$2.00 USD",2,-0.36,1.64,7036.19,"USD","hledger","hledger","rhyanki","Rishi Hyanki","STRIPE","CREDITCARD",,"",,,
"2023-02-01T02:10:38","7c8c092a","cf2b2393","Host Fee to Open Source Collective","DEBIT","HOST_FEE","","","","-$0.20 USD",-0.2,0,-0.2,7034.55,"USD","hledger","hledger","opensource","Open Source Collective",,,,"",,,
"2023-02-01T01:13:32","0aa8a618","5b10d7b8","Monthly contribution from Michael Martinides (Individuals)","CREDIT","CONTRIBUTION","","","","$2.00 USD",2,-0.38,1.62,7034.75,"USD","hledger","hledger","michael-martinides","Michael Martinides","STRIPE","CREDITCARD",,"",,,
"2023-02-01T01:13:32","5acf8554","5b10d7b8","Host Fee to Open Source Collective","DEBIT","HOST_FEE","","","","-$0.20 USD",-0.2,0,-0.2,7033.13,"USD","hledger","hledger","opensource","Open Source Collective",,,,"",,,
"2023-01-31T10:47:37","75545e8b","f309fa68","Monthly contribution from Richard Kelly (Individuals)","CREDIT","CONTRIBUTION","","","","$2.00 USD",2,-0.56,1.44,7033.33,"USD","hledger","hledger","richard-kelly","Richard Kelly","PAYPAL","SUBSCRIPTION",,"",,,
"2023-01-31T10:47:36","37da025a","f309fa68","Host Fee to Open Source Collective","DEBIT","HOST_FEE","","","","-$0.20 USD",-0.2,0,-0.2,7031.89,"USD","hledger","hledger","opensource","Open Source Collective",,,,"",,,
"2023-01-26T01:01:27","a50a6343","12235cd0","Expense from Chris Lemaire - Bounty issue 1984","DEBIT","EXPENSE","","","","-$12.00 USD",-12,-0.24,-12.24,7032.09,"USD","hledger","hledger","chris-lemaire","Chris Lemaire",,,"INVOICE","","PAYPAL",,
"2023-01-24T20:13:58","06804feb","48beabb9","Contribution from Yann Büchau","CREDIT","CONTRIBUTION","","","","$12.00 USD",12,-1.09,10.91,7044.33,"USD","hledger","hledger","yann-buechau","Yann Büchau","PAYPAL","PAYMENT",,"",,,
"2023-01-24T20:13:57","58dda67f","48beabb9","Host Fee to Open Source Collective","DEBIT","HOST_FEE","","","","-$1.20 USD",-1.2,0,-1.2,7033.42,"USD","hledger","hledger","opensource","Open Source Collective",,,,"",,,
"2023-01-24T10:57:16","af790a6c","230c6dce","Monthly contribution from Olsens Revision ApS (Individuals)","CREDIT","CONTRIBUTION","","","","$25.00 USD",25,-1.74,23.26,7034.62,"USD","hledger","hledger","olsensrevision","Olsens Revision ApS","PAYPAL","SUBSCRIPTION",,"",,,
"2023-01-24T10:57:16","12c36a55","230c6dce","Host Fee to Open Source Collective","DEBIT","HOST_FEE","","","","-$2.50 USD",-2.5,0,-2.5,7011.36,"USD","hledger","hledger","opensource","Open Source Collective",,,,"",,,
"2023-01-23T11:20:19","383bb440","342efc3d","Monthly contribution from Guest (Individuals)","CREDIT","CONTRIBUTION","","","","$2.00 USD",2,-0.59,1.41,7013.86,"USD","hledger","hledger","guest-d120c27f","Guest","PAYPAL","SUBSCRIPTION",,"",,,
"2023-01-23T11:20:19","085c290f","342efc3d","Host Fee to Open Source Collective","DEBIT","HOST_FEE","","","","-$0.20 USD",-0.2,0,-0.2,7012.45,"USD","hledger","hledger","opensource","Open Source Collective",,,,"",,,
"2023-01-02T10:14:58","ce748256","40cb0d90","Monthly contribution from Crash Game (Individuals)","CREDIT","CONTRIBUTION","","","","$5.00 USD",5,-0.5,4.5,7012.65,"USD","hledger","hledger","crash-game","Crash Game","STRIPE","CREDITCARD",,"",,,
"2023-01-02T10:14:58","6f83ca7d","40cb0d90","Host Fee to Open Source Collective","DEBIT","HOST_FEE","","","","-$0.50 USD",-0.5,0,-0.5,7008.15,"USD","hledger","hledger","opensource","Open Source Collective",,,,"",,,
"2023-01-02T10:12:51","328af047","c22a946b","Monthly contribution from Aviator Game (Individuals)","CREDIT","CONTRIBUTION","","","","$5.00 USD",5,-0.5,4.5,7008.65,"USD","hledger","hledger","aviator-game1","Aviator Game",,,,"",,,
"2023-01-02T10:12:51","44a5167d","c22a946b","Host Fee to Open Source Collective","DEBIT","HOST_FEE","","","","-$0.50 USD",-0.5,0,-0.5,7004.15,"USD","hledger","hledger","opensource","Open Source Collective",,,,"",,,
"2023-01-01T20:10:11","ec35f4a0","f38872f8","Monthly contribution from Frank (Individuals)","CREDIT","CONTRIBUTION","","","","$2.00 USD",2,-0.38,1.62,7004.65,"USD","hledger","hledger","guest-4c0726ae","Frank","STRIPE","CREDITCARD",,"",,,
"2023-01-01T20:10:11","5f815bdb","f38872f8","Host Fee to Open Source Collective","DEBIT","HOST_FEE","","","","-$0.20 USD",-0.2,0,-0.2,7003.03,"USD","hledger","hledger","opensource","Open Source Collective",,,,"",,,
"2023-01-01T18:04:52","6bde45ea","76335827","Monthly contribution from Ken Ewing (Individuals)","CREDIT","CONTRIBUTION","","","","$2.00 USD",2,-0.36,1.64,7003.23,"USD","hledger","hledger","ken-ewing","Ken Ewing","STRIPE","CREDITCARD",,"",,,
"2023-01-01T18:04:52","f898849c","76335827","Host Fee to Open Source Collective","DEBIT","HOST_FEE","","","","-$0.20 USD",-0.2,0,-0.2,7001.59,"USD","hledger","hledger","opensource","Open Source Collective",,,,"",,,
"2023-01-01T15:02:22","afe01e8a","61a3bcc4","Monthly contribution from Brandon J Wong (Individuals)","CREDIT","CONTRIBUTION","","","","$2.00 USD",2,-0.38,1.62,7001.79,"USD","hledger","hledger","brandon-j-wong","Brandon J Wong",,,,"",,,
"2023-01-01T15:02:22","045c4164","61a3bcc4","Host Fee to Open Source Collective","DEBIT","HOST_FEE","","","","-$0.20 USD",-0.2,0,-0.2,7000.17,"USD","hledger","hledger","opensource","Open Source Collective",,,,"",,,
"2023-01-01T12:17:12","6b537cf8","c22e84f4","Monthly contribution from James Blachly (Individuals)","CREDIT","CONTRIBUTION","","","","$2.00 USD",2,-0.36,1.64,7000.37,"USD","hledger","hledger","james-blachly","James Blachly","STRIPE","CREDITCARD",,"",,,
"2023-01-01T12:17:12","b1b458a9","c22e84f4","Host Fee to Open Source Collective","DEBIT","HOST_FEE","","","","-$0.20 USD",-0.2,0,-0.2,6998.73,"USD","hledger","hledger","opensource","Open Source Collective",,,,"",,,
"2023-01-01T09:07:35","7579d53b","bd25c3fa","Yearly contribution from incognito","CREDIT","CONTRIBUTION","","","","$50.00 USD",50,-2.25,47.75,6998.93,"USD","hledger","hledger","incognito-6a1e7e79","incognito","STRIPE","CREDITCARD",,"",,,
"2023-01-01T09:07:35","7340552d","bd25c3fa","Host Fee to Open Source Collective","DEBIT","HOST_FEE","","","","-$5.00 USD",-5,0,-5,6951.18,"USD","hledger","hledger","opensource","Open Source Collective",,,,"",,,
"2023-01-01T06:06:06","8692b74b","5b4dbcab","Monthly contribution from Jack Todaro (Individuals)","CREDIT","CONTRIBUTION","","","","$2.00 USD",2,-0.38,1.62,6956.18,"USD","hledger","hledger","jack-todaro","Jack Todaro","STRIPE","CREDITCARD",,"",,,
"2023-01-01T06:06:06","3e5c7b82","5b4dbcab","Host Fee to Open Source Collective","DEBIT","HOST_FEE","","","","-$0.20 USD",-0.2,0,-0.2,6954.56,"USD","hledger","hledger","opensource","Open Source Collective",,,,"",,,
"2023-01-01T04:01:57","169ff802","36689815","Monthly contribution from October Swimmer (Organisations)","CREDIT","CONTRIBUTION","","","","$100.00 USD",100,-3.2,96.8,6954.76,"USD","hledger","hledger","october-swimmer","October Swimmer",,,,"",,,
"2023-01-01T04:01:56","1b4ad188","36689815","Host Fee to Open Source Collective","DEBIT","HOST_FEE","","","","-$10.00 USD",-10,0,-10,6857.96,"USD","hledger","hledger","opensource","Open Source Collective",,,,"",,,
"2023-01-01T03:06:33","7a4955b0","bc71fb15","Monthly contribution from Brandon Barker (Individuals)","CREDIT","CONTRIBUTION","","","","$2.00 USD",2,-0.36,1.64,6867.96,"USD","hledger","hledger","brandonbarker","Brandon Barker","STRIPE","CREDITCARD",,"",,,
"2023-01-01T03:06:33","2d1bc70b","bc71fb15","Host Fee to Open Source Collective","DEBIT","HOST_FEE","","","","-$0.20 USD",-0.2,0,-0.2,6866.32,"USD","hledger","hledger","opensource","Open Source Collective",,,,"",,,
"2023-01-01T02:11:38","a3f35df0","fc768b03","Monthly contribution from Rishi Hyanki (Individuals)","CREDIT","CONTRIBUTION","","","","$2.00 USD",2,-0.36,1.64,6866.52,"USD","hledger","hledger","rhyanki","Rishi Hyanki","STRIPE","CREDITCARD",,"",,,
"2023-01-01T02:11:38","564eb6d6","fc768b03","Host Fee to Open Source Collective","DEBIT","HOST_FEE","","","","-$0.20 USD",-0.2,0,-0.2,6864.88,"USD","hledger","hledger","opensource","Open Source Collective",,,,"",,,
"2023-01-01T01:14:36","052c4d11","36bf0628","Monthly contribution from Michael Martinides (Individuals)","CREDIT","CONTRIBUTION","","","","$2.00 USD",2,-0.38,1.62,6865.08,"USD","hledger","hledger","michael-martinides","Michael Martinides","STRIPE","CREDITCARD",,"",,,
"2023-01-01T01:14:36","1b822482","36bf0628","Host Fee to Open Source Collective","DEBIT","HOST_FEE","","","","-$0.20 USD",-0.2,0,-0.2,6863.46,"USD","hledger","hledger","opensource","Open Source Collective",,,,"",,,
"2022-12-31T10:39:37","37530f11","07cbeb28","Monthly contribution from Richard Kelly (Individuals)","CREDIT","CONTRIBUTION","","","","$2.00 USD",2,-0.56,1.44,6863.66,"USD","hledger","hledger","richard-kelly","Richard Kelly","PAYPAL","SUBSCRIPTION",,"",,,
"2022-12-31T10:39:36","a37475dd","07cbeb28","Host Fee to Open Source Collective","DEBIT","HOST_FEE","","","","-$0.20 USD",-0.2,0,-0.2,6862.22,"USD","hledger","hledger","opensource","Open Source Collective",,,,"",,,
"2022-12-24T11:15:34","b2b373cc","0dab9eb9","Monthly contribution from Olsens Revision ApS (Individuals)","CREDIT","CONTRIBUTION","","","","$25.00 USD",25,-1.74,23.26,6862.42,"USD","hledger","hledger","olsensrevision","Olsens Revision ApS","PAYPAL","SUBSCRIPTION",,"",,,
"2022-12-24T11:15:34","4d9f14c6","0dab9eb9","Host Fee to Open Source Collective","DEBIT","HOST_FEE","","","","-$2.50 USD",-2.5,0,-2.5,6839.16,"USD","hledger","hledger","opensource","Open Source Collective",,,,"",,,
"2022-12-23T10:28:22","9c106aaf","20b69359","Monthly contribution from Guest (Individuals)","CREDIT","CONTRIBUTION","","","","$2.00 USD",2,-0.59,1.41,6841.66,"USD","hledger","hledger","guest-d120c27f","Guest","PAYPAL","SUBSCRIPTION",,"",,,
"2022-12-23T10:28:22","73995b73","20b69359","Host Fee to Open Source Collective","DEBIT","HOST_FEE","","","","-$0.20 USD",-0.2,0,-0.2,6840.25,"USD","hledger","hledger","opensource","Open Source Collective",,,,"",,,
"2022-12-12T00:12:49","76ffa9b1","3ee985bd","Expense from Andras Fabian - regression bounty","DEBIT","EXPENSE","","","","-$100.00 USD",-100,-0.83,-100.83,6840.45,"USD","hledger","hledger","andras-fabian","Andras Fabian",,,"INVOICE","","BANK_ACCOUNT",,
"2022-12-08T10:26:34","0b0cf90f","0f6ba1a9","Monthly contribution from Targeted Organic Traffic (Individuals)","CREDIT","CONTRIBUTION","","","","$2.00 USD",2,-0.59,1.41,6941.28,"USD","hledger","hledger","targeted-organic-traffic","Targeted Organic Traffic","PAYPAL","SUBSCRIPTION",,"",,,
"2022-12-08T10:26:34","d4f2aaf3","0f6ba1a9","Host Fee to Open Source Collective","DEBIT","HOST_FEE","","","","-$0.20 USD",-0.2,0,-0.2,6939.87,"USD","hledger","hledger","opensource","Open Source Collective",,,,"",,,
"2022-12-07T11:20:04","eba000ce","3b596441","Monthly contribution from Real Targeted Traffic (Individuals)","CREDIT","CONTRIBUTION","","","","$2.00 USD",2,-0.59,1.41,6940.07,"USD","hledger","hledger","seo25-com","Real Targeted Traffic","PAYPAL","SUBSCRIPTION",,"",,,
"2022-12-07T11:20:04","1d588f68","3b596441","Host Fee to Open Source Collective","DEBIT","HOST_FEE","","","","-$0.20 USD",-0.2,0,-0.2,6938.66,"USD","hledger","hledger","opensource","Open Source Collective",,,,"",,,
"2022-12-01T21:07:44","52cc676b","83376438","Monthly contribution from Frank (Individuals)","CREDIT","CONTRIBUTION","","","","$2.00 USD",2,-0.38,1.62,6938.86,"USD","hledger","hledger","guest-4c0726ae","Frank","STRIPE","CREDITCARD",,"",,,
"2022-12-01T21:07:44","10d2e0bc","83376438","Host Fee to Open Source Collective","DEBIT","HOST_FEE","","","","-$0.20 USD",-0.2,0,-0.2,6937.24,"USD","hledger","hledger","opensource","Open Source Collective",,,,"",,,
"2022-12-01T18:18:38","9fd6643e","72d62459","Monthly contribution from Ken Ewing (Individuals)","CREDIT","CONTRIBUTION","","","","$2.00 USD",2,-0.36,1.64,6937.44,"USD","hledger","hledger","ken-ewing","Ken Ewing","STRIPE","CREDITCARD",,"",,,
"2022-12-01T18:18:38","18b40a89","72d62459","Host Fee to Open Source Collective","DEBIT","HOST_FEE","","","","-$0.20 USD",-0.2,0,-0.2,6935.8,"USD","hledger","hledger","opensource","Open Source Collective",,,,"",,,
"2022-12-01T15:14:35","f4245622","8d22b7e7","Monthly contribution from Brandon J Wong (Individuals)","CREDIT","CONTRIBUTION","","","","$2.00 USD",2,-0.38,1.62,6936,"USD","hledger","hledger","brandon-j-wong","Brandon J Wong",,,,"",,,
"2022-12-01T15:14:35","c47f3070","8d22b7e7","Host Fee to Open Source Collective","DEBIT","HOST_FEE","","","","-$0.20 USD",-0.2,0,-0.2,6934.38,"USD","hledger","hledger","opensource","Open Source Collective",,,,"",,,
"2022-12-01T13:08:50","7f3d9bb9","d181dc67","Monthly contribution from James Blachly (Individuals)","CREDIT","CONTRIBUTION","","","","$2.00 USD",2,-0.36,1.64,6934.58,"USD","hledger","hledger","james-blachly","James Blachly","STRIPE","CREDITCARD",,"",,,
"2022-12-01T13:08:50","bf1b7b62","d181dc67","Host Fee to Open Source Collective","DEBIT","HOST_FEE","","","","-$0.20 USD",-0.2,0,-0.2,6932.94,"USD","hledger","hledger","opensource","Open Source Collective",,,,"",,,
"2022-12-01T07:02:41","c7e34d72","473da75d","Monthly contribution from Tony Xiao (Individuals)","CREDIT","CONTRIBUTION","","","","$10.00 USD",10,-0.59,9.41,6933.14,"USD","hledger","hledger","tony-xiao1","Tony Xiao","STRIPE","CREDITCARD",,"",,,
"2022-12-01T07:02:41","e31c7f7d","473da75d","Host Fee to Open Source Collective","DEBIT","HOST_FEE","","","","-$1.00 USD",-1,0,-1,6923.73,"USD","hledger","hledger","opensource","Open Source Collective",,,,"",,,
"2022-12-01T06:10:15","7bd26248","49b8a44a","Monthly contribution from Jack Todaro (Individuals)","CREDIT","CONTRIBUTION","","","","$2.00 USD",2,-0.38,1.62,6924.73,"USD","hledger","hledger","jack-todaro","Jack Todaro","STRIPE","CREDITCARD",,"",,,
"2022-12-01T06:10:15","9debd51a","49b8a44a","Host Fee to Open Source Collective","DEBIT","HOST_FEE","","","","-$0.20 USD",-0.2,0,-0.2,6923.11,"USD","hledger","hledger","opensource","Open Source Collective",,,,"",,,
"2022-12-01T04:05:26","7210d18c","a0ab33cc","Monthly contribution from October Swimmer (Organisations)","CREDIT","CONTRIBUTION","","","","$100.00 USD",100,-3.2,96.8,6923.31,"USD","hledger","hledger","october-swimmer","October Swimmer",,,,"",,,
"2022-12-01T04:05:26","345ee19b","a0ab33cc","Host Fee to Open Source Collective","DEBIT","HOST_FEE","","","","-$10.00 USD",-10,0,-10,6826.51,"USD","hledger","hledger","opensource","Open Source Collective",,,,"",,,
"2022-12-01T03:10:09","7d6ec401","ff61f9e4","Monthly contribution from Brandon Barker (Individuals)","CREDIT","CONTRIBUTION","","","","$2.00 USD",2,-0.36,1.64,6836.51,"USD","hledger","hledger","brandonbarker","Brandon Barker","STRIPE","CREDITCARD",,"",,,
"2022-12-01T03:10:09","af58c29b","ff61f9e4","Host Fee to Open Source Collective","DEBIT","HOST_FEE","","","","-$0.20 USD",-0.2,0,-0.2,6834.87,"USD","hledger","hledger","opensource","Open Source Collective",,,,"",,,
"2022-12-01T02:18:12","600d79e7","d77a9c8e","Monthly contribution from Rishi Hyanki (Individuals)","CREDIT","CONTRIBUTION","","","","$2.00 USD",2,-0.36,1.64,6835.07,"USD","hledger","hledger","rhyanki","Rishi Hyanki","STRIPE","CREDITCARD",,"",,,
"2022-12-01T02:18:12","404cb657","d77a9c8e","Host Fee to Open Source Collective","DEBIT","HOST_FEE","","","","-$0.20 USD",-0.2,0,-0.2,6833.43,"USD","hledger","hledger","opensource","Open Source Collective",,,,"",,,
"2022-12-01T01:19:14","70022e4f","7875c75f","Monthly contribution from Michael Martinides (Individuals)","CREDIT","CONTRIBUTION","","","","$2.00 USD",2,-0.38,1.62,6833.63,"USD","hledger","hledger","michael-martinides","Michael Martinides","STRIPE","CREDITCARD",,"",,,
"2022-12-01T01:19:14","1aed0dc7","7875c75f","Host Fee to Open Source Collective","DEBIT","HOST_FEE","","","","-$0.20 USD",-0.2,0,-0.2,6832.01,"USD","hledger","hledger","opensource","Open Source Collective",,,,"",,,
"2022-11-30T10:44:38","0edd766b","146fa804","Monthly contribution from Richard Kelly (Individuals)","CREDIT","CONTRIBUTION","","","","$2.00 USD",2,-0.56,1.44,6832.21,"USD","hledger","hledger","richard-kelly","Richard Kelly","PAYPAL","SUBSCRIPTION",,"",,,
"2022-11-30T10:44:38","afdb2718","146fa804","Host Fee to Open Source Collective","DEBIT","HOST_FEE","","","","-$0.20 USD",-0.2,0,-0.2,6830.77,"USD","hledger","hledger","opensource","Open Source Collective",,,,"",,,
"2022-11-26T21:00:14","74643aea","2c7dea09","Monthly contribution from Crash Game (Individuals)","CREDIT","CONTRIBUTION","","","","$5.00 USD",5,-0.5,4.5,6830.97,"USD","hledger","hledger","crash-game","Crash Game","STRIPE","CREDITCARD",,"",,,
"2022-11-26T21:00:14","0f8b0bc5","2c7dea09","Host Fee to Open Source Collective","DEBIT","HOST_FEE","","","","-$0.50 USD",-0.5,0,-0.5,6826.47,"USD","hledger","hledger","opensource","Open Source Collective",,,,"",,,
"2022-11-25T23:02:28","44e6b266","6d402817","Monthly contribution from Aviator Game (Individuals)","CREDIT","CONTRIBUTION","","","","$5.00 USD",5,-0.5,4.5,6826.97,"USD","hledger","hledger","aviator-game1","Aviator Game",,,,"",,,
"2022-11-25T23:02:28","5dd98fcc","6d402817","Host Fee to Open Source Collective","DEBIT","HOST_FEE","","","","-$0.50 USD",-0.5,0,-0.5,6822.47,"USD","hledger","hledger","opensource","Open Source Collective",,,,"",,,
"2022-11-24T11:09:41","cfa6d66d","83ea1d79","Monthly contribution from Olsens Revision ApS (Individuals)","CREDIT","CONTRIBUTION","","","","$25.00 USD",25,-1.74,23.26,6822.97,"USD","hledger","hledger","olsensrevision","Olsens Revision ApS","PAYPAL","SUBSCRIPTION",,"",,,
"2022-11-24T11:09:41","75691bdc","83ea1d79","Host Fee to Open Source Collective","DEBIT","HOST_FEE","","","","-$2.50 USD",-2.5,0,-2.5,6799.71,"USD","hledger","hledger","opensource","Open Source Collective",,,,"",,,
"2022-11-23T10:36:59","7962c2de","435c45c8","Monthly contribution from Guest (Individuals)","CREDIT","CONTRIBUTION","","","","$2.00 USD",2,-0.59,1.41,6802.21,"USD","hledger","hledger","guest-d120c27f","Guest","PAYPAL","SUBSCRIPTION",,"",,,
"2022-11-23T10:36:59","8c380281","435c45c8","Host Fee to Open Source Collective","DEBIT","HOST_FEE","","","","-$0.20 USD",-0.2,0,-0.2,6800.8,"USD","hledger","hledger","opensource","Open Source Collective",,,,"",,,
"2022-11-08T10:27:15","dc0bc920","9492436a","Monthly contribution from Targeted Organic Traffic (Individuals)","CREDIT","CONTRIBUTION","","","","$2.00 USD",2,-0.59,1.41,6801,"USD","hledger","hledger","targeted-organic-traffic","Targeted Organic Traffic","PAYPAL","SUBSCRIPTION",,"",,,
"2022-11-08T10:27:15","efec4666","9492436a","Host Fee to Open Source Collective","DEBIT","HOST_FEE","","","","-$0.20 USD",-0.2,0,-0.2,6799.59,"USD","hledger","hledger","opensource","Open Source Collective",,,,"",,,
"2022-11-07T11:10:53","bd4a1190","a2d84ae2","Monthly contribution from Real Targeted Traffic (Individuals)","CREDIT","CONTRIBUTION","","","","$2.00 USD",2,-0.59,1.41,6799.79,"USD","hledger","hledger","seo25-com","Real Targeted Traffic","PAYPAL","SUBSCRIPTION",,"",,,
"2022-11-07T11:10:53","69c41d7d","a2d84ae2","Host Fee to Open Source Collective","DEBIT","HOST_FEE","","","","-$0.20 USD",-0.2,0,-0.2,6798.38,"USD","hledger","hledger","opensource","Open Source Collective",,,,"",,,
"2022-11-02T06:04:12","c08c6293","f7c17452","Monthly contribution from Brandon J Wong (Individuals)","CREDIT","CONTRIBUTION","","","","$2.00 USD",2,-0.38,1.62,6798.58,"USD","hledger","hledger","brandon-j-wong","Brandon J Wong",,,,"",,,
"2022-11-02T06:04:12","880be7e7","f7c17452","Host Fee to Open Source Collective","DEBIT","HOST_FEE","","","","-$0.20 USD",-0.2,0,-0.2,6796.96,"USD","hledger","hledger","opensource","Open Source Collective",,,,"",,,
"2022-11-01T22:19:44","b38d9237","00ea61dc","Monthly contribution from James Blachly (Individuals)","CREDIT","CONTRIBUTION","","","","$2.00 USD",2,-0.36,1.64,6797.16,"USD","hledger","hledger","james-blachly","James Blachly","STRIPE","CREDITCARD",,"",,,
"2022-11-01T22:19:44","a53315db","00ea61dc","Host Fee to Open Source Collective","DEBIT","HOST_FEE","","","","-$0.20 USD",-0.2,0,-0.2,6795.52,"USD","hledger","hledger","opensource","Open Source Collective",,,,"",,,
"2022-11-01T22:07:23","fe4e9604","353320b5","Monthly contribution from Jack Todaro (Individuals)","CREDIT","CONTRIBUTION","","","","$2.00 USD",2,-0.38,1.62,6795.72,"USD","hledger","hledger","jack-todaro","Jack Todaro","STRIPE","CREDITCARD",,"",,,
"2022-11-01T22:07:23","01ce3c5b","353320b5","Host Fee to Open Source Collective","DEBIT","HOST_FEE","","","","-$0.20 USD",-0.2,0,-0.2,6794.1,"USD","hledger","hledger","opensource","Open Source Collective",,,,"",,,
"2022-11-01T16:11:54","fba15e29","f9d114a3","Monthly contribution from Ken Ewing (Individuals)","CREDIT","CONTRIBUTION","","","","$2.00 USD",2,-0.36,1.64,6794.3,"USD","hledger","hledger","ken-ewing","Ken Ewing","STRIPE","CREDITCARD",,"",,,
"2022-11-01T16:11:54","5a8e8bc2","f9d114a3","Host Fee to Open Source Collective","DEBIT","HOST_FEE","","","","-$0.20 USD",-0.2,0,-0.2,6792.66,"USD","hledger","hledger","opensource","Open Source Collective",,,,"",,,
"2022-11-01T07:19:20","e762d404","5730faa3","Monthly contribution from Brandon Barker (Individuals)","CREDIT","CONTRIBUTION","","","","$2.00 USD",2,-0.36,1.64,6792.86,"USD","hledger","hledger","brandonbarker","Brandon Barker","STRIPE","CREDITCARD",,"",,,
"2022-11-01T07:19:19","dd9486b1","5730faa3","Host Fee to Open Source Collective","DEBIT","HOST_FEE","","","","-$0.20 USD",-0.2,0,-0.2,6791.22,"USD","hledger","hledger","opensource","Open Source Collective",,,,"",,,
"2022-11-01T07:18:40","273167f9","85da7810","Monthly contribution from Tony Xiao (Individuals)","CREDIT","CONTRIBUTION","","","","$10.00 USD",10,-0.59,9.41,6791.42,"USD","hledger","hledger","tony-xiao1","Tony Xiao","STRIPE","CREDITCARD",,"",,,
"2022-11-01T07:18:40","75ea378e","85da7810","Host Fee to Open Source Collective","DEBIT","HOST_FEE","","","","-$1.00 USD",-1,0,-1,6782.01,"USD","hledger","hledger","opensource","Open Source Collective",,,,"",,,
"2022-11-01T07:17:20","8fedef2d","99edbdda","Monthly contribution from Rishi Hyanki (Individuals)","CREDIT","CONTRIBUTION","","","","$2.00 USD",2,-0.36,1.64,6783.01,"USD","hledger","hledger","rhyanki","Rishi Hyanki","STRIPE","CREDITCARD",,"",,,
"2022-11-01T07:17:20","b913e574","99edbdda","Host Fee to Open Source Collective","DEBIT","HOST_FEE","","","","-$0.20 USD",-0.2,0,-0.2,6781.37,"USD","hledger","hledger","opensource","Open Source Collective",,,,"",,,
"2022-11-01T03:16:39","23b6bc8a","898202a9","Monthly contribution from Frank (Individuals)","CREDIT","CONTRIBUTION","","","","$2.00 USD",2,-0.38,1.62,6781.57,"USD","hledger","hledger","guest-4c0726ae","Frank","STRIPE","CREDITCARD",,"",,,
"2022-11-01T03:16:39","9803272f","898202a9","Host Fee to Open Source Collective","DEBIT","HOST_FEE","","","","-$0.20 USD",-0.2,0,-0.2,6779.95,"USD","hledger","hledger","opensource","Open Source Collective",,,,"",,,
"2022-11-01T00:14:38","b387b429","ad85a239","Monthly contribution from Michael Martinides (Individuals)","CREDIT","CONTRIBUTION","","","","$2.00 USD",2,-0.38,1.62,6780.15,"USD","hledger","hledger","michael-martinides","Michael Martinides","STRIPE","CREDITCARD",,"",,,
"2022-11-01T00:14:38","bbb4ff63","ad85a239","Host Fee to Open Source Collective","DEBIT","HOST_FEE","","","","-$0.20 USD",-0.2,0,-0.2,6778.53,"USD","hledger","hledger","opensource","Open Source Collective",,,,"",,,
"2022-11-01T00:13:52","1adbf7fc","aaccfc6f","Monthly contribution from October Swimmer (Organisations)","CREDIT","CONTRIBUTION","","","","$100.00 USD",100,-3.2,96.8,6778.73,"USD","hledger","hledger","october-swimmer","October Swimmer",,,,"",,,
"2022-11-01T00:13:52","f1d57194","aaccfc6f","Host Fee to Open Source Collective","DEBIT","HOST_FEE","","","","-$10.00 USD",-10,0,-10,6681.93,"USD","hledger","hledger","opensource","Open Source Collective",,,,"",,,
"2022-10-31T10:22:52","e86d868c","3ada7ca2","Monthly contribution from Richard Kelly (Individuals)","CREDIT","CONTRIBUTION","","","","$2.00 USD",2,-0.56,1.44,6691.93,"USD","hledger","hledger","richard-kelly","Richard Kelly","PAYPAL","SUBSCRIPTION",,"",,,
"2022-10-31T10:22:52","f4e0805b","3ada7ca2","Host Fee to Open Source Collective","DEBIT","HOST_FEE","","","","-$0.20 USD",-0.2,0,-0.2,6690.49,"USD","hledger","hledger","opensource","Open Source Collective",,,,"",,,
"2022-10-24T10:34:45","4e07557f","489bb4af","Monthly contribution from Olsens Revision ApS (Individuals)","CREDIT","CONTRIBUTION","","","","$25.00 USD",25,-1.74,23.26,6690.69,"USD","hledger","hledger","olsensrevision","Olsens Revision ApS","PAYPAL","SUBSCRIPTION",,"",,,
"2022-10-24T10:34:45","9acb3c8f","489bb4af","Host Fee to Open Source Collective","DEBIT","HOST_FEE","","","","-$2.50 USD",-2.5,0,-2.5,6667.43,"USD","hledger","hledger","opensource","Open Source Collective",,,,"",,,
"2022-10-23T11:17:32","cfc237ce","5fb69e24","Monthly contribution from Guest (Individuals)","CREDIT","CONTRIBUTION","","","","$2.00 USD",2,-0.59,1.41,6669.93,"USD","hledger","hledger","guest-d120c27f","Guest","PAYPAL","SUBSCRIPTION",,"",,,
"2022-10-23T11:17:32","53bdcd77","5fb69e24","Host Fee to Open Source Collective","DEBIT","HOST_FEE","","","","-$0.20 USD",-0.2,0,-0.2,6668.52,"USD","hledger","hledger","opensource","Open Source Collective",,,,"",,,
"2022-10-08T11:08:52","5c68283e","ecd50665","Monthly contribution from Targeted Organic Traffic (Individuals)","CREDIT","CONTRIBUTION","","","","$2.00 USD",2,-0.59,1.41,6668.72,"USD","hledger","hledger","targeted-organic-traffic","Targeted Organic Traffic","PAYPAL","SUBSCRIPTION",,"",,,
"2022-10-08T11:08:51","6563d257","ecd50665","Host Fee to Open Source Collective","DEBIT","HOST_FEE","","","","-$0.20 USD",-0.2,0,-0.2,6667.31,"USD","hledger","hledger","opensource","Open Source Collective",,,,"",,,
"2022-10-07T10:17:35","2929521d","05cd2b78","Monthly contribution from Real Targeted Traffic (Individuals)","CREDIT","CONTRIBUTION","","","","$2.00 USD",2,-0.59,1.41,6667.51,"USD","hledger","hledger","seo25-com","Real Targeted Traffic","PAYPAL","SUBSCRIPTION",,"",,,
"2022-10-07T10:17:35","91cef534","05cd2b78","Host Fee to Open Source Collective","DEBIT","HOST_FEE","","","","-$0.20 USD",-0.2,0,-0.2,6666.1,"USD","hledger","hledger","opensource","Open Source Collective",,,,"",,,
"2022-10-02T05:12:19","ad4385c5","48e60b27","Monthly contribution from Brandon J Wong (Individuals)","CREDIT","CONTRIBUTION","","","","$2.00 USD",2,-0.38,1.62,6666.3,"USD","hledger","hledger","brandon-j-wong","Brandon J Wong",,,,"",,,
"2022-10-02T05:12:19","24b3b186","48e60b27","Host Fee to Open Source Collective","DEBIT","HOST_FEE","","","","-$0.20 USD",-0.2,0,-0.2,6664.68,"USD","hledger","hledger","opensource","Open Source Collective",,,,"",,,
"2022-10-01T23:13:29","6cc44945","0b3ccffc","Monthly contribution from James Blachly (Individuals)","CREDIT","CONTRIBUTION","","","","$2.00 USD",2,-0.36,1.64,6664.88,"USD","hledger","hledger","james-blachly","James Blachly","STRIPE","CREDITCARD",,"",,,
"2022-10-01T23:13:29","65e3105d","0b3ccffc","Host Fee to Open Source Collective","DEBIT","HOST_FEE","","","","-$0.20 USD",-0.2,0,-0.2,6663.24,"USD","hledger","hledger","opensource","Open Source Collective",,,,"",,,
"2022-10-01T22:20:31","d487cd12","976d6c33","Monthly contribution from Jack Todaro (Individuals)","CREDIT","CONTRIBUTION","","","","$2.00 USD",2,-0.38,1.62,6663.44,"USD","hledger","hledger","jack-todaro","Jack Todaro","STRIPE","CREDITCARD",,"",,,
"2022-10-01T22:20:31","8e8ac8c2","976d6c33","Host Fee to Open Source Collective","DEBIT","HOST_FEE","","","","-$0.20 USD",-0.2,0,-0.2,6661.82,"USD","hledger","hledger","opensource","Open Source Collective",,,,"",,,
"2022-10-01T17:01:17","b4148f16","fa4e08b3","Monthly contribution from Ken Ewing (Individuals)","CREDIT","CONTRIBUTION","","","","$2.00 USD",2,-0.36,1.64,6662.02,"USD","hledger","hledger","ken-ewing","Ken Ewing","STRIPE","CREDITCARD",,"",,,
"2022-10-01T17:01:17","6d2e3310","fa4e08b3","Host Fee to Open Source Collective","DEBIT","HOST_FEE","","","","-$0.20 USD",-0.2,0,-0.2,6660.38,"USD","hledger","hledger","opensource","Open Source Collective",,,,"",,,
"2022-10-01T08:10:52","64c81f7f","34038627","Monthly contribution from Brandon Barker (Individuals)","CREDIT","CONTRIBUTION","","","","$2.00 USD",2,-0.36,1.64,6660.58,"USD","hledger","hledger","brandonbarker","Brandon Barker","STRIPE","CREDITCARD",,"",,,
"2022-10-01T08:10:52","988bd985","34038627","Host Fee to Open Source Collective","DEBIT","HOST_FEE","","","","-$0.20 USD",-0.2,0,-0.2,6658.94,"USD","hledger","hledger","opensource","Open Source Collective",,,,"",,,
"2022-10-01T08:10:04","0c8b5572","e18a0685","Monthly contribution from Tony Xiao (Individuals)","CREDIT","CONTRIBUTION","","","","$10.00 USD",10,-0.59,9.41,6659.14,"USD","hledger","hledger","tony-xiao1","Tony Xiao","STRIPE","CREDITCARD",,"",,,
"2022-10-01T08:10:04","394dabb5","e18a0685","Host Fee to Open Source Collective","DEBIT","HOST_FEE","","","","-$1.00 USD",-1,0,-1,6649.73,"USD","hledger","hledger","opensource","Open Source Collective",,,,"",,,
"2022-10-01T08:08:49","e6141c69","ca6cbe54","Monthly contribution from Rishi Hyanki (Individuals)","CREDIT","CONTRIBUTION","","","","$2.00 USD",2,-0.36,1.64,6650.73,"USD","hledger","hledger","rhyanki","Rishi Hyanki","STRIPE","CREDITCARD",,"",,,
"2022-10-01T08:08:49","db58419c","ca6cbe54","Host Fee to Open Source Collective","DEBIT","HOST_FEE","","","","-$0.20 USD",-0.2,0,-0.2,6649.09,"USD","hledger","hledger","opensource","Open Source Collective",,,,"",,,
"2022-10-01T03:18:04","e1daeceb","54344606","Monthly contribution from Frank (Individuals)","CREDIT","CONTRIBUTION","","","","$2.00 USD",2,-0.38,1.62,6649.29,"USD","hledger","hledger","guest-4c0726ae","Frank","STRIPE","CREDITCARD",,"",,,
"2022-10-01T03:18:04","e037c829","54344606","Host Fee to Open Source Collective","DEBIT","HOST_FEE","","","","-$0.20 USD",-0.2,0,-0.2,6647.67,"USD","hledger","hledger","opensource","Open Source Collective",,,,"",,,
"2022-10-01T00:15:09","932d16c3","5e3eedd0","Monthly contribution from Michael Martinides (Individuals)","CREDIT","CONTRIBUTION","","","","$2.00 USD",2,-0.38,1.62,6647.87,"USD","hledger","hledger","michael-martinides","Michael Martinides","STRIPE","CREDITCARD",,"",,,
"2022-10-01T00:15:09","8e544cef","5e3eedd0","Host Fee to Open Source Collective","DEBIT","HOST_FEE","","","","-$0.20 USD",-0.2,0,-0.2,6646.25,"USD","hledger","hledger","opensource","Open Source Collective",,,,"",,,
"2022-10-01T00:14:19","b6d4d15e","e1df2eb5","Monthly contribution from October Swimmer (Organisations)","CREDIT","CONTRIBUTION","","","","$100.00 USD",100,-3.2,96.8,6646.45,"USD","hledger","hledger","october-swimmer","October Swimmer",,,,"",,,
"2022-10-01T00:14:19","01cddc5e","e1df2eb5","Host Fee to Open Source Collective","DEBIT","HOST_FEE","","","","-$10.00 USD",-10,0,-10,6549.65,"USD","hledger","hledger","opensource","Open Source Collective",,,,"",,,
"2022-09-30T11:53:25","cd7144e1","9bd8e4e4","Monthly contribution from Richard Kelly (Individuals)","CREDIT","CONTRIBUTION","","","","$2.00 USD",2,-0.56,1.44,6559.65,"USD","hledger","hledger","richard-kelly","Richard Kelly","PAYPAL","SUBSCRIPTION",,"",,,
"2022-09-30T11:53:24","74dd72f9","9bd8e4e4","Host Fee to Open Source Collective","DEBIT","HOST_FEE","","","","-$0.20 USD",-0.2,0,-0.2,6558.21,"USD","hledger","hledger","opensource","Open Source Collective",,,,"",,,
"2022-09-24T10:41:09","adfec335","a4515b03","Monthly contribution from Olsens Revision ApS (Individuals)","CREDIT","CONTRIBUTION","","","","$25.00 USD",25,-1.74,23.26,6558.41,"USD","hledger","hledger","olsensrevision","Olsens Revision ApS","PAYPAL","SUBSCRIPTION",,"",,,
"2022-09-24T10:41:09","f23acb81","a4515b03","Host Fee to Open Source Collective","DEBIT","HOST_FEE","","","","-$2.50 USD",-2.5,0,-2.5,6535.15,"USD","hledger","hledger","opensource","Open Source Collective",,,,"",,,
"2022-09-23T10:28:06","06e54c2d","27d035ac","Monthly contribution from Guest (Individuals)","CREDIT","CONTRIBUTION","","","","$2.00 USD",2,-0.59,1.41,6537.65,"USD","hledger","hledger","guest-d120c27f","Guest","PAYPAL","SUBSCRIPTION",,"",,,
"2022-09-23T10:28:06","75d69fb6","27d035ac","Host Fee to Open Source Collective","DEBIT","HOST_FEE","","","","-$0.20 USD",-0.2,0,-0.2,6536.24,"USD","hledger","hledger","opensource","Open Source Collective",,,,"",,,
"2022-09-15T09:01:31","68976dd2","f17a7600","Expense from Simon Michael - regression bounty","DEBIT","EXPENSE","","","","-$100.00 USD",-100,-0.25,-100.25,6536.44,"USD","hledger","hledger","simon","Simon Michael",,,"INVOICE","","PAYPAL",,
"2022-09-15T07:20:22","688cb3a1","52026fe7","Expense from Eric Langlois - regression bounty","DEBIT","EXPENSE","","","","-$100.00 USD",-100,-0.94,-100.94,6636.69,"USD","hledger","hledger","eric-langlois","Eric Langlois",,,"INVOICE","","BANK_ACCOUNT",,
"2022-09-08T11:46:38","ae882109","37ad078c","Monthly contribution from Targeted Organic Traffic (Individuals)","CREDIT","CONTRIBUTION","","","","$2.00 USD",2,-0.59,1.41,6737.63,"USD","hledger","hledger","targeted-organic-traffic","Targeted Organic Traffic","PAYPAL","SUBSCRIPTION",,"",,,
"2022-09-08T11:46:38","73a610e7","37ad078c","Host Fee to Open Source Collective","DEBIT","HOST_FEE","","","","-$0.20 USD",-0.2,0,-0.2,6736.22,"USD","hledger","hledger","opensource","Open Source Collective",,,,"",,,
"2022-09-07T12:21:04","d8dea13f","aac672f8","Monthly contribution from Real Targeted Traffic (Individuals)","CREDIT","CONTRIBUTION","","","","$2.00 USD",2,-0.59,1.41,6736.42,"USD","hledger","hledger","seo25-com","Real Targeted Traffic","PAYPAL","SUBSCRIPTION",,"",,,
"2022-09-07T12:21:04","db2a5ae6","aac672f8","Host Fee to Open Source Collective","DEBIT","HOST_FEE","","","","-$0.20 USD",-0.2,0,-0.2,6735.01,"USD","hledger","hledger","opensource","Open Source Collective",,,,"",,,
"2022-09-02T17:07:56","3822ef04","44cee436","Monthly contribution from Brandon J Wong (Individuals)","CREDIT","CONTRIBUTION","","","","$2.00 USD",2,-0.38,1.62,6735.21,"USD","hledger","hledger","brandon-j-wong","Brandon J Wong",,,,"",,,
"2022-09-02T17:07:56","2ed63d45","44cee436","Host Fee to Open Source Collective","DEBIT","HOST_FEE","","","","-$0.20 USD",-0.2,0,-0.2,6733.59,"USD","hledger","hledger","opensource","Open Source Collective",,,,"",,,
"2022-09-02T11:22:27","a4065ed8","74cceb4c","Monthly contribution from James Blachly (Individuals)","CREDIT","CONTRIBUTION","","","","$2.00 USD",2,-0.36,1.64,6733.79,"USD","hledger","hledger","james-blachly","James Blachly","STRIPE","CREDITCARD",,"",,,
"2022-09-02T11:22:26","09e3627f","74cceb4c","Host Fee to Open Source Collective","DEBIT","HOST_FEE","","","","-$0.20 USD",-0.2,0,-0.2,6732.15,"USD","hledger","hledger","opensource","Open Source Collective",,,,"",,,
"2022-09-02T11:05:43","bfff71df","62592eb3","Monthly contribution from Jack Todaro (Individuals)","CREDIT","CONTRIBUTION","","","","$2.00 USD",2,-0.38,1.62,6732.35,"USD","hledger","hledger","jack-todaro","Jack Todaro","STRIPE","CREDITCARD",,"",,,
"2022-09-02T11:05:43","ad6ce945","62592eb3","Host Fee to Open Source Collective","DEBIT","HOST_FEE","","","","-$0.20 USD",-0.2,0,-0.2,6730.73,"USD","hledger","hledger","opensource","Open Source Collective",,,,"",,,
"2022-09-02T04:17:34","28863b2d","a93db4dd","Monthly contribution from Ken Ewing (Individuals)","CREDIT","CONTRIBUTION","","","","$2.00 USD",2,-0.36,1.64,6730.93,"USD","hledger","hledger","ken-ewing","Ken Ewing","STRIPE","CREDITCARD",,"",,,
"2022-09-02T04:17:34","a0aa0305","a93db4dd","Host Fee to Open Source Collective","DEBIT","HOST_FEE","","","","-$0.20 USD",-0.2,0,-0.2,6729.29,"USD","hledger","hledger","opensource","Open Source Collective",,,,"",,,
"2022-09-01T20:08:22","2371b58d","cea4ac9f","Monthly contribution from Brandon Barker (Individuals)","CREDIT","CONTRIBUTION","","","","$2.00 USD",2,-0.36,1.64,6729.49,"USD","hledger","hledger","brandonbarker","Brandon Barker","STRIPE","CREDITCARD",,"",,,
"2022-09-01T20:08:22","18a61896","cea4ac9f","Host Fee to Open Source Collective","DEBIT","HOST_FEE","","","","-$0.20 USD",-0.2,0,-0.2,6727.85,"USD","hledger","hledger","opensource","Open Source Collective",,,,"",,,
"2022-09-01T20:07:24","422ae3b4","e315f881","Monthly contribution from Tony Xiao (Individuals)","CREDIT","CONTRIBUTION","","","","$10.00 USD",10,-0.59,9.41,6728.05,"USD","hledger","hledger","tony-xiao1","Tony Xiao","STRIPE","CREDITCARD",,"",,,
"2022-09-01T20:07:24","0ecf5304","e315f881","Host Fee to Open Source Collective","DEBIT","HOST_FEE","","","","-$1.00 USD",-1,0,-1,6718.64,"USD","hledger","hledger","opensource","Open Source Collective",,,,"",,,
"2022-09-01T20:06:04","974c87ff","64ab9151","Monthly contribution from Rishi Hyanki (Individuals)","CREDIT","CONTRIBUTION","","","","$2.00 USD",2,-0.36,1.64,6719.64,"USD","hledger","hledger","rhyanki","Rishi Hyanki","STRIPE","CREDITCARD",,"",,,
"2022-09-01T20:06:04","acbbfdb5","64ab9151","Host Fee to Open Source Collective","DEBIT","HOST_FEE","","","","-$0.20 USD",-0.2,0,-0.2,6718,"USD","hledger","hledger","opensource","Open Source Collective",,,,"",,,
"2022-09-01T15:17:15","2351cbd6","69be5671","Monthly contribution from Frank (Individuals)","CREDIT","CONTRIBUTION","","","","$2.00 USD",2,-0.38,1.62,6718.2,"USD","hledger","hledger","guest-4c0726ae","Frank","STRIPE","CREDITCARD",,"",,,
"2022-09-01T15:17:15","a61587e3","69be5671","Host Fee to Open Source Collective","DEBIT","HOST_FEE","","","","-$0.20 USD",-0.2,0,-0.2,6716.58,"USD","hledger","hledger","opensource","Open Source Collective",,,,"",,,
"2022-09-01T14:14:42","5eb4b205","a6849ea4","Monthly contribution from MSATC (Individuals)","CREDIT","CONTRIBUTION","","","","$2.00 USD",2,-0.38,1.62,6716.78,"USD","hledger","hledger","msatc","MSATC","STRIPE","CREDITCARD",,"",,,
"2022-09-01T14:14:42","9a33aa44","a6849ea4","Host Fee to Open Source Collective","DEBIT","HOST_FEE","","","","-$0.20 USD",-0.2,0,-0.2,6715.16,"USD","hledger","hledger","opensource","Open Source Collective",,,,"",,,
"2022-09-01T13:00:40","7e71e171","284405b6","Monthly contribution from Michael Martinides (Individuals)","CREDIT","CONTRIBUTION","","","","$2.00 USD",2,-0.38,1.62,6715.36,"USD","hledger","hledger","michael-martinides","Michael Martinides","STRIPE","CREDITCARD",,"",,,
"2022-09-01T13:00:39","f41569f4","284405b6","Host Fee to Open Source Collective","DEBIT","HOST_FEE","","","","-$0.20 USD",-0.2,0,-0.2,6713.74,"USD","hledger","hledger","opensource","Open Source Collective",,,,"",,,
"2022-09-01T12:59:38","78cef376","ec5f117b","Monthly contribution from October Swimmer (Organisations)","CREDIT","CONTRIBUTION","","","","$100.00 USD",100,-3.2,96.8,6713.94,"USD","hledger","hledger","october-swimmer","October Swimmer",,,,"",,,
"2022-09-01T12:59:38","ae4b8fc2","ec5f117b","Host Fee to Open Source Collective","DEBIT","HOST_FEE","","","","-$10.00 USD",-10,0,-10,6617.14,"USD","hledger","hledger","opensource","Open Source Collective",,,,"",,,
"2022-08-31T10:13:38","98c2f017","d3a3d588","Monthly contribution from Richard Kelly (Individuals)","CREDIT","CONTRIBUTION","","","","$2.00 USD",2,-0.56,1.44,6627.14,"USD","hledger","hledger","richard-kelly","Richard Kelly","PAYPAL","SUBSCRIPTION",,"",,,
"2022-08-31T10:13:38","c8f224c8","d3a3d588","Host Fee to Open Source Collective","DEBIT","HOST_FEE","","","","-$0.20 USD",-0.2,0,-0.2,6625.7,"USD","hledger","hledger","opensource","Open Source Collective",,,,"",,,
"2022-08-24T11:59:13","0d6adaf5","d4b72292","Monthly contribution from Olsens Revision ApS (Individuals)","CREDIT","CONTRIBUTION","","","","$100.00 USD",100,-5.48,94.52,6625.9,"USD","hledger","hledger","olsensrevision","Olsens Revision ApS","PAYPAL","SUBSCRIPTION",,"",,,
"2022-08-24T11:59:13","4daa92d4","d4b72292","Host Fee to Open Source Collective","DEBIT","HOST_FEE","","","","-$10.00 USD",-10,0,-10,6531.38,"USD","hledger","hledger","opensource","Open Source Collective",,,,"",,,
"2022-08-23T11:27:23","f35fda09","d615568f","Monthly contribution from Guest (Individuals)","CREDIT","CONTRIBUTION","","","","$2.00 USD",2,-0.59,1.41,6541.38,"USD","hledger","hledger","guest-d120c27f","Guest","PAYPAL","SUBSCRIPTION",,"",,,
"2022-08-23T11:27:23","671afc2d","d615568f","Host Fee to Open Source Collective","DEBIT","HOST_FEE","","","","-$0.20 USD",-0.2,0,-0.2,6539.97,"USD","hledger","hledger","opensource","Open Source Collective",,,,"",,,
"2022-08-08T10:18:41","ae41d803","70009743","Monthly contribution from Targeted Organic Traffic (Individuals)","CREDIT","CONTRIBUTION","","","","$2.00 USD",2,-0.59,1.41,6540.17,"USD","hledger","hledger","targeted-organic-traffic","Targeted Organic Traffic","PAYPAL","SUBSCRIPTION",,"",,,
"2022-08-08T10:18:41","9aa7bd79","70009743","Host Fee to Open Source Collective","DEBIT","HOST_FEE","","","","-$0.20 USD",-0.2,0,-0.2,6538.76,"USD","hledger","hledger","opensource","Open Source Collective",,,,"",,,
"2022-08-07T12:25:11","c4aa56d4","4bf13104","Monthly contribution from Real Targeted Traffic (Individuals)","CREDIT","CONTRIBUTION","","","","$2.00 USD",2,-0.59,1.41,6538.96,"USD","hledger","hledger","seo25-com","Real Targeted Traffic","PAYPAL","SUBSCRIPTION",,"",,,
"2022-08-07T12:25:11","5e66dc0c","4bf13104","Host Fee to Open Source Collective","DEBIT","HOST_FEE","","","","-$0.20 USD",-0.2,0,-0.2,6537.55,"USD","hledger","hledger","opensource","Open Source Collective",,,,"",,,
"2022-08-02T05:08:11","378edcfc","febebc42","Monthly contribution from Brandon J Wong (Individuals)","CREDIT","CONTRIBUTION","","","","$2.00 USD",2,-0.38,1.62,6537.75,"USD","hledger","hledger","brandon-j-wong","Brandon J Wong",,,,"",,,
"2022-08-02T05:08:11","63977e52","febebc42","Host Fee to Open Source Collective","DEBIT","HOST_FEE","","","","-$0.20 USD",-0.2,0,-0.2,6536.13,"USD","hledger","hledger","opensource","Open Source Collective",,,,"",,,
"2022-08-02T01:07:28","c582b6d0","401fe01f","Monthly contribution from James Blachly (Individuals)","CREDIT","CONTRIBUTION","","","","$2.00 USD",2,-0.36,1.64,6536.33,"USD","hledger","hledger","james-blachly","James Blachly","STRIPE","CREDITCARD",,"",,,
"2022-08-02T01:07:28","cebc489c","401fe01f","Host Fee to Open Source Collective","DEBIT","HOST_FEE","","","","-$0.20 USD",-0.2,0,-0.2,6534.69,"USD","hledger","hledger","opensource","Open Source Collective",,,,"",,,
"2022-08-02T00:12:29","02c8ca65","464d5909","Monthly contribution from Jack Todaro (Individuals)","CREDIT","CONTRIBUTION","","","","$2.00 USD",2,-0.38,1.62,6534.89,"USD","hledger","hledger","jack-todaro","Jack Todaro","STRIPE","CREDITCARD",,"",,,
"2022-08-02T00:12:29","7eb2ab73","464d5909","Host Fee to Open Source Collective","DEBIT","HOST_FEE","","","","-$0.20 USD",-0.2,0,-0.2,6533.27,"USD","hledger","hledger","opensource","Open Source Collective",,,,"",,,
"2022-08-01T17:19:56","ecb0b6c6","f17b4632","Monthly contribution from Ken Ewing (Individuals)","CREDIT","CONTRIBUTION","","","","$2.00 USD",2,-0.36,1.64,6533.47,"USD","hledger","hledger","ken-ewing","Ken Ewing","STRIPE","CREDITCARD",,"",,,
"2022-08-01T17:19:56","72fb0c10","f17b4632","Host Fee to Open Source Collective","DEBIT","HOST_FEE","","","","-$0.20 USD",-0.2,0,-0.2,6531.83,"USD","hledger","hledger","opensource","Open Source Collective",,,,"",,,
"2022-08-01T08:16:38","ca17feec","9cbaa57c","Monthly contribution from Brandon Barker (Individuals)","CREDIT","CONTRIBUTION","","","","$2.00 USD",2,-0.36,1.64,6532.03,"USD","hledger","hledger","brandonbarker","Brandon Barker","STRIPE","CREDITCARD",,"",,,
"2022-08-01T08:16:38","80d26b88","9cbaa57c","Host Fee to Open Source Collective","DEBIT","HOST_FEE","","","","-$0.20 USD",-0.2,0,-0.2,6530.39,"USD","hledger","hledger","opensource","Open Source Collective",,,,"",,,
"2022-08-01T08:16:01","3546a6ce","aabf5c5f","Monthly contribution from Tony Xiao (Individuals)","CREDIT","CONTRIBUTION","","","","$10.00 USD",10,-0.59,9.41,6530.59,"USD","hledger","hledger","tony-xiao1","Tony Xiao","STRIPE","CREDITCARD",,"",,,
"2022-08-01T08:16:01","426354fc","aabf5c5f","Host Fee to Open Source Collective","DEBIT","HOST_FEE","","","","-$1.00 USD",-1,0,-1,6521.18,"USD","hledger","hledger","opensource","Open Source Collective",,,,"",,,
"2022-08-01T08:14:30","43c4e251","93105d77","Monthly contribution from Rishi Hyanki (Individuals)","CREDIT","CONTRIBUTION","","","","$2.00 USD",2,-0.36,1.64,6522.18,"USD","hledger","hledger","rhyanki","Rishi Hyanki","STRIPE","CREDITCARD",,"",,,
"2022-08-01T08:14:30","634ec6ab","93105d77","Host Fee to Open Source Collective","DEBIT","HOST_FEE","","","","-$0.20 USD",-0.2,0,-0.2,6520.54,"USD","hledger","hledger","opensource","Open Source Collective",,,,"",,,
"2022-08-01T04:02:00","281ac0a8","a686486d","Monthly contribution from Frank (Individuals)","CREDIT","CONTRIBUTION","","","","$2.00 USD",2,-0.38,1.62,6520.74,"USD","hledger","hledger","guest-4c0726ae","Frank","STRIPE","CREDITCARD",,"",,,
"2022-08-01T04:01:59","e6fda85f","a686486d","Host Fee to Open Source Collective","DEBIT","HOST_FEE","","","","-$0.20 USD",-0.2,0,-0.2,6519.12,"USD","hledger","hledger","opensource","Open Source Collective",,,,"",,,
"2022-08-01T02:16:21","7e068bc7","02fca645","Monthly contribution from MSATC (Individuals)","CREDIT","CONTRIBUTION","","","","$2.00 USD",2,-0.38,1.62,6519.32,"USD","hledger","hledger","msatc","MSATC","STRIPE","CREDITCARD",,"",,,
"2022-08-01T02:16:20","f3ff14b6","02fca645","Host Fee to Open Source Collective","DEBIT","HOST_FEE","","","","-$0.20 USD",-0.2,0,-0.2,6517.7,"USD","hledger","hledger","opensource","Open Source Collective",,,,"",,,
"2022-08-01T00:16:31","b56bd3a3","d9d8bad4","Monthly contribution from Michael Martinides (Individuals)","CREDIT","CONTRIBUTION","","","","$2.00 USD",2,-0.38,1.62,6517.9,"USD","hledger","hledger","michael-martinides","Michael Martinides","STRIPE","CREDITCARD",,"",,,
"2022-08-01T00:16:31","eebeb04c","d9d8bad4","Host Fee to Open Source Collective","DEBIT","HOST_FEE","","","","-$0.20 USD",-0.2,0,-0.2,6516.28,"USD","hledger","hledger","opensource","Open Source Collective",,,,"",,,
"2022-08-01T00:15:38","6084ba35","5eceeb69","Monthly contribution from October Swimmer (Organisations)","CREDIT","CONTRIBUTION","","","","$100.00 USD",100,-3.2,96.8,6516.48,"USD","hledger","hledger","october-swimmer","October Swimmer",,,,"",,,
"2022-08-01T00:15:38","d667cb1c","5eceeb69","Host Fee to Open Source Collective","DEBIT","HOST_FEE","","","","-$10.00 USD",-10,0,-10,6419.68,"USD","hledger","hledger","opensource","Open Source Collective",,,,"",,,
"2022-07-31T10:39:23","50cccef6","98b37ec5","Monthly contribution from Richard Kelly (Individuals)","CREDIT","CONTRIBUTION","","","","$2.00 USD",2,-0.56,1.44,6429.68,"USD","hledger","hledger","richard-kelly","Richard Kelly","PAYPAL","SUBSCRIPTION",,"",,,
"2022-07-31T10:39:23","f3e2bd44","98b37ec5","Host Fee to Open Source Collective","DEBIT","HOST_FEE","","","","-$0.20 USD",-0.2,0,-0.2,6428.24,"USD","hledger","hledger","opensource","Open Source Collective",,,,"",,,
"2022-07-24T11:27:26","fbd2e86c","3cd89062","Monthly contribution from Olsens Revision ApS (Individuals)","CREDIT","CONTRIBUTION","","","","$100.00 USD",100,-5.48,94.52,6428.44,"USD","hledger","hledger","olsensrevision","Olsens Revision ApS","PAYPAL","SUBSCRIPTION",,"",,,
"2022-07-24T11:27:26","6d436d49","3cd89062","Host Fee to Open Source Collective","DEBIT","HOST_FEE","","","","-$10.00 USD",-10,0,-10,6333.92,"USD","hledger","hledger","opensource","Open Source Collective",,,,"",,,
"2022-07-23T10:40:31","3a8614dc","a8c877a4","Monthly contribution from Guest (Individuals)","CREDIT","CONTRIBUTION","","","","$2.00 USD",2,-0.59,1.41,6343.92,"USD","hledger","hledger","guest-d120c27f","Guest","PAYPAL","SUBSCRIPTION",,"",,,
"2022-07-23T10:40:30","29824c73","a8c877a4","Host Fee to Open Source Collective","DEBIT","HOST_FEE","","","","-$0.20 USD",-0.2,0,-0.2,6342.51,"USD","hledger","hledger","opensource","Open Source Collective",,,,"",,,
"2022-07-22T10:46:36","ecbd3a28","6d75f4df","Contribution from pablo","CREDIT","CONTRIBUTION","","","","$50.00 USD",50,-2.99,47.01,6342.71,"USD","hledger","hledger","pablo6","pablo","PAYPAL","PAYMENT",,"",,,
"2022-07-22T10:46:36","dc0bcd82","6d75f4df","Host Fee to Open Source Collective","DEBIT","HOST_FEE","","","","-$5.00 USD",-5,0,-5,6295.7,"USD","hledger","hledger","opensource","Open Source Collective",,,,"",,,
"2022-07-08T11:45:21","06bde8c2","b2f80a2d","Monthly contribution from Targeted Organic Traffic (Individuals)","CREDIT","CONTRIBUTION","","","","$2.00 USD",2,-0.59,1.41,6300.7,"USD","hledger","hledger","targeted-organic-traffic","Targeted Organic Traffic","PAYPAL","SUBSCRIPTION",,"",,,
"2022-07-08T11:45:21","fa66e4d0","b2f80a2d","Host Fee to Open Source Collective","DEBIT","HOST_FEE","","","","-$0.20 USD",-0.2,0,-0.2,6299.29,"USD","hledger","hledger","opensource","Open Source Collective",,,,"",,,
"2022-07-07T10:38:36","d1672f70","ff675511","Monthly contribution from Real Targeted Traffic (Individuals)","CREDIT","CONTRIBUTION","","","","$2.00 USD",2,-0.59,1.41,6299.49,"USD","hledger","hledger","seo25-com","Real Targeted Traffic","PAYPAL","SUBSCRIPTION",,"",,,
"2022-07-07T10:38:36","63804006","ff675511","Host Fee to Open Source Collective","DEBIT","HOST_FEE","","","","-$0.20 USD",-0.2,0,-0.2,6298.08,"USD","hledger","hledger","opensource","Open Source Collective",,,,"",,,
"2022-07-02T04:16:25","5ff452be","e1ef4746","Monthly contribution from Brandon J Wong (Individuals)","CREDIT","CONTRIBUTION","","","","$2.00 USD",2,-0.38,1.62,6298.28,"USD","hledger","hledger","brandon-j-wong","Brandon J Wong",,,,"",,,
"2022-07-02T04:16:24","d971bd07","e1ef4746","Host Fee to Open Source Collective","DEBIT","HOST_FEE","","","","-$0.20 USD",-0.2,0,-0.2,6296.66,"USD","hledger","hledger","opensource","Open Source Collective",,,,"",,,
"2022-07-02T02:06:07","904ed133","e8133e38","Monthly contribution from James Blachly (Individuals)","CREDIT","CONTRIBUTION","","","","$2.00 USD",2,-0.36,1.64,6296.86,"USD","hledger","hledger","james-blachly","James Blachly","STRIPE","CREDITCARD",,"",,,
"2022-07-02T02:06:07","e01ed379","e8133e38","Host Fee to Open Source Collective","DEBIT","HOST_FEE","","","","-$0.20 USD",-0.2,0,-0.2,6295.22,"USD","hledger","hledger","opensource","Open Source Collective",,,,"",,,
"2022-07-02T01:08:21","cbeca9cb","2aad764c","Monthly contribution from Jack Todaro (Individuals)","CREDIT","CONTRIBUTION","","","","$2.00 USD",2,-0.38,1.62,6295.42,"USD","hledger","hledger","jack-todaro","Jack Todaro","STRIPE","CREDITCARD",,"",,,
"2022-07-02T01:08:21","2e6c416d","2aad764c","Host Fee to Open Source Collective","DEBIT","HOST_FEE","","","","-$0.20 USD",-0.2,0,-0.2,6293.8,"USD","hledger","hledger","opensource","Open Source Collective",,,,"",,,
"2022-07-01T18:14:00","cb2048c0","44d989ed","Monthly contribution from Ken Ewing (Individuals)","CREDIT","CONTRIBUTION","","","","$2.00 USD",2,-0.36,1.64,6294,"USD","hledger","hledger","ken-ewing","Ken Ewing","STRIPE","CREDITCARD",,"",,,
"2022-07-01T18:14:00","f4ab5b02","44d989ed","Host Fee to Open Source Collective","DEBIT","HOST_FEE","","","","-$0.20 USD",-0.2,0,-0.2,6292.36,"USD","hledger","hledger","opensource","Open Source Collective",,,,"",,,
"2022-07-01T12:21:00","7fd8d1f1","e133cc23","Monthly contribution from Writers Per Hour (Organisations)","CREDIT","CONTRIBUTION","","","","$100.00 USD",100,-4.2,95.8,6292.56,"USD","hledger","hledger","writersperhour","Writers Per Hour","STRIPE","CREDITCARD",,"",,,
"2022-07-01T12:21:00","a28a01eb","e133cc23","Host Fee to Open Source Collective","DEBIT","HOST_FEE","","","","-$10.00 USD",-10,0,-10,6196.76,"USD","hledger","hledger","opensource","Open Source Collective",,,,"",,,
"2022-07-01T09:13:19","43251ab8","58622bb6","Monthly contribution from Brandon Barker (Individuals)","CREDIT","CONTRIBUTION","","","","$2.00 USD",2,-0.36,1.64,6206.76,"USD","hledger","hledger","brandonbarker","Brandon Barker","STRIPE","CREDITCARD",,"",,,
"2022-07-01T09:13:19","1e87c90e","58622bb6","Host Fee to Open Source Collective","DEBIT","HOST_FEE","","","","-$0.20 USD",-0.2,0,-0.2,6205.12,"USD","hledger","hledger","opensource","Open Source Collective",,,,"",,,
"2022-07-01T09:03:29","bf0e6845","480d1b2b","Monthly contribution from Tony Xiao (Individuals)","CREDIT","CONTRIBUTION","","","","$10.00 USD",10,-0.59,9.41,6205.32,"USD","hledger","hledger","tony-xiao1","Tony Xiao","STRIPE","CREDITCARD",,"",,,
"2022-07-01T09:03:29","aeb19966","480d1b2b","Host Fee to Open Source Collective","DEBIT","HOST_FEE","","","","-$1.00 USD",-1,0,-1,6195.91,"USD","hledger","hledger","opensource","Open Source Collective",,,,"",,,
"2022-07-01T09:02:06","17a65606","bc4d28f0","Monthly contribution from Rishi Hyanki (Individuals)","CREDIT","CONTRIBUTION","","","","$2.00 USD",2,-0.36,1.64,6196.91,"USD","hledger","hledger","rhyanki","Rishi Hyanki","STRIPE","CREDITCARD",,"",,,
"2022-07-01T09:02:06","4ec7eaa7","bc4d28f0","Host Fee to Open Source Collective","DEBIT","HOST_FEE","","","","-$0.20 USD",-0.2,0,-0.2,6195.27,"USD","hledger","hledger","opensource","Open Source Collective",,,,"",,,
"2022-07-01T04:04:43","bca88686","393a462e","Monthly contribution from Frank (Individuals)","CREDIT","CONTRIBUTION","","","","$2.00 USD",2,-0.38,1.62,6195.47,"USD","hledger","hledger","guest-4c0726ae","Frank","STRIPE","CREDITCARD",,"",,,
"2022-07-01T04:04:43","970c013e","393a462e","Host Fee to Open Source Collective","DEBIT","HOST_FEE","","","","-$0.20 USD",-0.2,0,-0.2,6193.85,"USD","hledger","hledger","opensource","Open Source Collective",,,,"",,,
"2022-07-01T02:18:24","50463907","82365c8f","Monthly contribution from MSATC (Individuals)","CREDIT","CONTRIBUTION","","","","$2.00 USD",2,-0.38,1.62,6194.05,"USD","hledger","hledger","msatc","MSATC","STRIPE","CREDITCARD",,"",,,
"2022-07-01T02:18:24","49a92e42","82365c8f","Host Fee to Open Source Collective","DEBIT","HOST_FEE","","","","-$0.20 USD",-0.2,0,-0.2,6192.43,"USD","hledger","hledger","opensource","Open Source Collective",,,,"",,,
"2022-07-01T00:14:05","3ff2d8c6","1fcd31f1","Monthly contribution from Michael Martinides (Individuals)","CREDIT","CONTRIBUTION","","","","$2.00 USD",2,-0.38,1.62,6192.63,"USD","hledger","hledger","michael-martinides","Michael Martinides","STRIPE","CREDITCARD",,"",,,
"2022-07-01T00:14:05","ebd903d2","1fcd31f1","Host Fee to Open Source Collective","DEBIT","HOST_FEE","","","","-$0.20 USD",-0.2,0,-0.2,6191.01,"USD","hledger","hledger","opensource","Open Source Collective",,,,"",,,
"2022-07-01T00:13:23","4383a1b2","3e4c5145","Monthly contribution from October Swimmer (Organisations)","CREDIT","CONTRIBUTION","","","","$100.00 USD",100,-3.2,96.8,6191.21,"USD","hledger","hledger","october-swimmer","October Swimmer",,,,"",,,
"2022-07-01T00:13:23","4e5bf09f","3e4c5145","Host Fee to Open Source Collective","DEBIT","HOST_FEE","","","","-$10.00 USD",-10,0,-10,6094.41,"USD","hledger","hledger","opensource","Open Source Collective",,,,"",,,
"2022-06-30T12:18:35","5af6e110","f8cb9470","Monthly contribution from Richard Kelly (Individuals)","CREDIT","CONTRIBUTION","","","","$2.00 USD",2,-0.56,1.44,6104.41,"USD","hledger","hledger","richard-kelly","Richard Kelly","PAYPAL","SUBSCRIPTION",,"",,,
"2022-06-30T12:18:35","12c98b74","f8cb9470","Host Fee to Open Source Collective","DEBIT","HOST_FEE","","","","-$0.20 USD",-0.2,0,-0.2,6102.97,"USD","hledger","hledger","opensource","Open Source Collective",,,,"",,,
"2022-06-24T12:08:17","1f85b3be","8c08256f","Monthly contribution from Olsens Revision ApS (Individuals)","CREDIT","CONTRIBUTION","","","","$100.00 USD",100,-5.48,94.52,6103.17,"USD","hledger","hledger","olsensrevision","Olsens Revision ApS","PAYPAL","SUBSCRIPTION",,"",,,
"2022-06-24T12:08:17","c4c19acf","8c08256f","Host Fee to Open Source Collective","DEBIT","HOST_FEE","","","","-$10.00 USD",-10,0,-10,6008.65,"USD","hledger","hledger","opensource","Open Source Collective",,,,"",,,
"2022-06-23T11:58:58","9c8abfd9","2347d402","Monthly contribution from Guest (Individuals)","CREDIT","CONTRIBUTION","","","","$2.00 USD",2,-0.59,1.41,6018.65,"USD","hledger","hledger","guest-d120c27f","Guest","PAYPAL","SUBSCRIPTION",,"",,,
"2022-06-23T11:58:58","e51dd4a4","2347d402","Host Fee to Open Source Collective","DEBIT","HOST_FEE","","","","-$0.20 USD",-0.2,0,-0.2,6017.24,"USD","hledger","hledger","opensource","Open Source Collective",,,,"",,,
"2022-06-17T01:37:32","99b0f569","320b8cbc","Contribution from Michael Manganiello","CREDIT","CONTRIBUTION","","","","$5.00 USD",5,-0.74,4.26,6017.44,"USD","hledger","hledger","guest-c173624c","Michael Manganiello","PAYPAL","PAYMENT",,"",,,
"2022-06-17T01:37:32","fc7c3144","320b8cbc","Host Fee to Open Source Collective","DEBIT","HOST_FEE","","","","-$0.50 USD",-0.5,0,-0.5,6013.18,"USD","hledger","hledger","opensource","Open Source Collective",,,,"",,,
"2022-06-08T11:51:58","e82a4082","9bd2e7fc","Monthly contribution from Targeted Organic Traffic (Individuals)","CREDIT","CONTRIBUTION","","","","$2.00 USD",2,-0.59,1.41,6013.68,"USD","hledger","hledger","targeted-organic-traffic","Targeted Organic Traffic","PAYPAL","SUBSCRIPTION",,"",,,
"2022-06-08T11:51:58","db5a4eae","9bd2e7fc","Host Fee to Open Source Collective","DEBIT","HOST_FEE","","","","-$0.20 USD",-0.2,0,-0.2,6012.27,"USD","hledger","hledger","opensource","Open Source Collective",,,,"",,,
"2022-06-07T12:16:14","32f61544","fe859308","Monthly contribution from Real Targeted Traffic (Individuals)","CREDIT","CONTRIBUTION","","","","$2.00 USD",2,-0.59,1.41,6012.47,"USD","hledger","hledger","seo25-com","Real Targeted Traffic","PAYPAL","SUBSCRIPTION",,"",,,
"2022-06-07T12:16:14","d10bd7ea","fe859308","Host Fee to Open Source Collective","DEBIT","HOST_FEE","","","","-$0.20 USD",-0.2,0,-0.2,6011.06,"USD","hledger","hledger","opensource","Open Source Collective",,,,"",,,
"2022-06-02T04:10:09","ee9bf9ca","3899155a","Monthly contribution from Brandon J Wong (Individuals)","CREDIT","CONTRIBUTION","","","","$2.00 USD",2,-0.38,1.62,6011.26,"USD","hledger","hledger","brandon-j-wong","Brandon J Wong",,,,"",,,
"2022-06-02T04:10:09","fdc1db30","3899155a","Host Fee to Open Source Collective","DEBIT","HOST_FEE","","","","-$0.20 USD",-0.2,0,-0.2,6009.64,"USD","hledger","hledger","opensource","Open Source Collective",,,,"",,,
"2022-06-02T03:03:17","a0fc2777","b2ad2289","Monthly contribution from James Blachly (Individuals)","CREDIT","CONTRIBUTION","","","","$2.00 USD",2,-0.36,1.64,6009.84,"USD","hledger","hledger","james-blachly","James Blachly","STRIPE","CREDITCARD",,"",,,
"2022-06-02T03:03:17","a6ab5718","b2ad2289","Host Fee to Open Source Collective","DEBIT","HOST_FEE","","","","-$0.20 USD",-0.2,0,-0.2,6008.2,"USD","hledger","hledger","opensource","Open Source Collective",,,,"",,,
"2022-06-02T02:08:10","43532007","a03285be","Monthly contribution from Jack Todaro (Individuals)","CREDIT","CONTRIBUTION","","","","$2.00 USD",2,-0.38,1.62,6008.4,"USD","hledger","hledger","jack-todaro","Jack Todaro","STRIPE","CREDITCARD",,"",,,
"2022-06-02T02:08:10","b9d18470","a03285be","Host Fee to Open Source Collective","DEBIT","HOST_FEE","","","","-$0.20 USD",-0.2,0,-0.2,6006.78,"USD","hledger","hledger","opensource","Open Source Collective",,,,"",,,
"2022-06-01T19:14:39","669e6262","37c49e33","Monthly contribution from Ken Ewing (Individuals)","CREDIT","CONTRIBUTION","","","","$2.00 USD",2,-0.36,1.64,6006.98,"USD","hledger","hledger","ken-ewing","Ken Ewing","STRIPE","CREDITCARD",,"",,,
"2022-06-01T19:14:39","64f0a2bb","37c49e33","Host Fee to Open Source Collective","DEBIT","HOST_FEE","","","","-$0.20 USD",-0.2,0,-0.2,6005.34,"USD","hledger","hledger","opensource","Open Source Collective",,,,"",,,
"2022-06-01T13:22:14","790d533f","7693709c","Monthly contribution from Writers Per Hour (Organisations)","CREDIT","CONTRIBUTION","","","","$100.00 USD",100,-4.2,95.8,6005.54,"USD","hledger","hledger","writersperhour","Writers Per Hour","STRIPE","CREDITCARD",,"",,,
"2022-06-01T13:22:14","41470c52","7693709c","Host Fee to Open Source Collective","DEBIT","HOST_FEE","","","","-$10.00 USD",-10,0,-10,5909.74,"USD","hledger","hledger","opensource","Open Source Collective",,,,"",,,
"2022-06-01T09:10:26","d18f9683","900fe1f2","Monthly contribution from Brandon Barker (Individuals)","CREDIT","CONTRIBUTION","","","","$2.00 USD",2,-0.36,1.64,5919.74,"USD","hledger","hledger","brandonbarker","Brandon Barker","STRIPE","CREDITCARD",,"",,,
"2022-06-01T09:10:26","0ec36f5a","900fe1f2","Host Fee to Open Source Collective","DEBIT","HOST_FEE","","","","-$0.20 USD",-0.2,0,-0.2,5918.1,"USD","hledger","hledger","opensource","Open Source Collective",,,,"",,,
"2022-06-01T09:09:33","80ae2f52","0b8461e6","Monthly contribution from Tony Xiao (Individuals)","CREDIT","CONTRIBUTION","","","","$10.00 USD",10,-0.59,9.41,5918.3,"USD","hledger","hledger","tony-xiao1","Tony Xiao","STRIPE","CREDITCARD",,"",,,
"2022-06-01T09:09:33","dc7ff0aa","0b8461e6","Host Fee to Open Source Collective","DEBIT","HOST_FEE","","","","-$1.00 USD",-1,0,-1,5908.89,"USD","hledger","hledger","opensource","Open Source Collective",,,,"",,,
"2022-06-01T09:08:14","99740eff","754dacff","Monthly contribution from Rishi Hyanki (Individuals)","CREDIT","CONTRIBUTION","","","","$2.00 USD",2,-0.36,1.64,5909.89,"USD","hledger","hledger","rhyanki","Rishi Hyanki","STRIPE","CREDITCARD",,"",,,
"2022-06-01T09:08:14","8d6bef35","754dacff","Host Fee to Open Source Collective","DEBIT","HOST_FEE","","","","-$0.20 USD",-0.2,0,-0.2,5908.25,"USD","hledger","hledger","opensource","Open Source Collective",,,,"",,,
"2022-06-01T04:07:59","5846c9a5","8bab4454","Monthly contribution from Frank (Individuals)","CREDIT","CONTRIBUTION","","","","$2.00 USD",2,-0.38,1.62,5908.45,"USD","hledger","hledger","guest-4c0726ae","Frank","STRIPE","CREDITCARD",,"",,,
"2022-06-01T04:07:59","bc73f112","8bab4454","Host Fee to Open Source Collective","DEBIT","HOST_FEE","","","","-$0.20 USD",-0.2,0,-0.2,5906.83,"USD","hledger","hledger","opensource","Open Source Collective",,,,"",,,
"2022-06-01T03:01:47","d579f318","c64e21cc","Monthly contribution from MSATC (Individuals)","CREDIT","CONTRIBUTION","","","","$2.00 USD",2,-0.38,1.62,5907.03,"USD","hledger","hledger","msatc","MSATC","STRIPE","CREDITCARD",,"",,,
"2022-06-01T03:01:47","5ff5d519","c64e21cc","Host Fee to Open Source Collective","DEBIT","HOST_FEE","","","","-$0.20 USD",-0.2,0,-0.2,5905.41,"USD","hledger","hledger","opensource","Open Source Collective",,,,"",,,
"2022-06-01T00:14:12","f53de162","8e2b0883","Monthly contribution from Michael Martinides (Individuals)","CREDIT","CONTRIBUTION","","","","$2.00 USD",2,-0.38,1.62,5905.61,"USD","hledger","hledger","michael-martinides","Michael Martinides","STRIPE","CREDITCARD",,"",,,
"2022-06-01T00:14:12","0867ac0b","8e2b0883","Host Fee to Open Source Collective","DEBIT","HOST_FEE","","","","-$0.20 USD",-0.2,0,-0.2,5903.99,"USD","hledger","hledger","opensource","Open Source Collective",,,,"",,,
"2022-06-01T00:13:19","75aeaf84","d49eb88a","Monthly contribution from October Swimmer (Organisations)","CREDIT","CONTRIBUTION","","","","$100.00 USD",100,-3.2,96.8,5904.19,"USD","hledger","hledger","october-swimmer","October Swimmer",,,,"",,,
"2022-06-01T00:13:19","35a13984","d49eb88a","Host Fee to Open Source Collective","DEBIT","HOST_FEE","","","","-$10.00 USD",-10,0,-10,5807.39,"USD","hledger","hledger","opensource","Open Source Collective",,,,"",,,
"2022-05-31T11:39:33","7ca2cc6f","ceee95f0","Monthly contribution from Richard Kelly (Individuals)","CREDIT","CONTRIBUTION","","","","$2.00 USD",2,-0.56,1.44,5817.39,"USD","hledger","hledger","richard-kelly","Richard Kelly","PAYPAL","SUBSCRIPTION",,"",,,
"2022-05-31T11:39:33","936960b0","ceee95f0","Host Fee to Open Source Collective","DEBIT","HOST_FEE","","","","-$0.20 USD",-0.2,0,-0.2,5815.95,"USD","hledger","hledger","opensource","Open Source Collective",,,,"",,,
"2022-05-24T12:09:11","23f1d869","d0bf407e","Monthly contribution from Olsens Revision ApS (Individuals)","CREDIT","CONTRIBUTION","","","","$100.00 USD",100,-5.48,94.52,5816.15,"USD","hledger","hledger","olsensrevision","Olsens Revision ApS","PAYPAL","SUBSCRIPTION",,"",,,
"2022-05-24T12:09:11","25cc55aa","d0bf407e","Host Fee to Open Source Collective","DEBIT","HOST_FEE","","","","-$10.00 USD",-10,0,-10,5721.63,"USD","hledger","hledger","opensource","Open Source Collective",,,,"",,,
"2022-05-23T10:40:49","169c305e","b21ed653","Monthly contribution from Guest (Individuals)","CREDIT","CONTRIBUTION","","","","$2.00 USD",2,-0.59,1.41,5731.63,"USD","hledger","hledger","guest-d120c27f","Guest","PAYPAL","SUBSCRIPTION",,"",,,
"2022-05-23T10:40:49","d6ed133f","b21ed653","Host Fee to Open Source Collective","DEBIT","HOST_FEE","","","","-$0.20 USD",-0.2,0,-0.2,5730.22,"USD","hledger","hledger","opensource","Open Source Collective",,,,"",,,
"2022-05-10T02:02:00","f49cd55c","eb7a56bc","Expense from Simon Michael - Financial Accounting textbook","DEBIT","EXPENSE","","","","-$78.12 USD",-78.12,-0.25,-78.37,5730.42,"USD","hledger","hledger","simon","Simon Michael",,,"RECEIPT","","PAYPAL",,
"2022-05-08T12:05:00","42f45b83","6a774fc6","Monthly contribution from Targeted Organic Traffic (Individuals)","CREDIT","CONTRIBUTION","","","","$2.00 USD",2,-0.59,1.41,5808.79,"USD","hledger","hledger","targeted-organic-traffic","Targeted Organic Traffic","PAYPAL","SUBSCRIPTION",,"",,,
"2022-05-08T12:05:00","90dc0090","6a774fc6","Host Fee to Open Source Collective","DEBIT","HOST_FEE","","","","-$0.20 USD",-0.2,0,-0.2,5807.38,"USD","hledger","hledger","opensource","Open Source Collective",,,,"",,,
"2022-05-07T10:03:15","32c4a1b8","d4d15775","Monthly contribution from Real Targeted Traffic (Individuals)","CREDIT","CONTRIBUTION","","","","$2.00 USD",2,-0.59,1.41,5807.58,"USD","hledger","hledger","seo25-com","Real Targeted Traffic","PAYPAL","SUBSCRIPTION",,"",,,
"2022-05-07T10:03:15","7867ff56","d4d15775","Host Fee to Open Source Collective","DEBIT","HOST_FEE","","","","-$0.20 USD",-0.2,0,-0.2,5806.17,"USD","hledger","hledger","opensource","Open Source Collective",,,,"",,,
"2022-05-05T00:08:51","7a734c67","a480abdb","Monthly contribution from James Blachly (Individuals)","CREDIT","CONTRIBUTION","","","","$2.00 USD",2,-0.36,1.64,5806.37,"USD","hledger","hledger","james-blachly","James Blachly","STRIPE","CREDITCARD",,"",,,
"2022-05-05T00:08:51","5d66ce0a","a480abdb","Host Fee to Open Source Collective","DEBIT","HOST_FEE","","","","-$0.20 USD",-0.2,0,-0.2,5804.73,"USD","hledger","hledger","opensource","Open Source Collective",,,,"",,,
"2022-05-02T05:03:42","220b943f","67ffd365","Monthly contribution from Brandon J Wong (Individuals)","CREDIT","CONTRIBUTION","","","","$2.00 USD",2,-0.38,1.62,5804.93,"USD","hledger","hledger","brandon-j-wong","Brandon J Wong",,,,"",,,
"2022-05-02T05:03:42","0602f62d","67ffd365","Host Fee to Open Source Collective","DEBIT","HOST_FEE","","","","-$0.20 USD",-0.2,0,-0.2,5803.31,"USD","hledger","hledger","opensource","Open Source Collective",,,,"",,,
"2022-05-02T03:14:53","46004872","9d8f47ce","Monthly contribution from Jack Todaro (Individuals)","CREDIT","CONTRIBUTION","","","","$2.00 USD",2,-0.38,1.62,5803.51,"USD","hledger","hledger","jack-todaro","Jack Todaro","STRIPE","CREDITCARD",,"",,,
"2022-05-02T03:14:53","632d9781","9d8f47ce","Host Fee to Open Source Collective","DEBIT","HOST_FEE","","","","-$0.20 USD",-0.2,0,-0.2,5801.89,"USD","hledger","hledger","opensource","Open Source Collective",,,,"",,,
"2022-05-01T21:11:02","52739d8a","0363e54f","Monthly contribution from Ken Ewing (Individuals)","CREDIT","CONTRIBUTION","","","","$2.00 USD",2,-0.36,1.64,5802.09,"USD","hledger","hledger","ken-ewing","Ken Ewing","STRIPE","CREDITCARD",,"",,,
"2022-05-01T21:11:02","303a8b1d","0363e54f","Host Fee to Open Source Collective","DEBIT","HOST_FEE","","","","-$0.20 USD",-0.2,0,-0.2,5800.45,"USD","hledger","hledger","opensource","Open Source Collective",,,,"",,,
"2022-05-01T15:02:37","3931c46c","5d5690df","Monthly contribution from Writers Per Hour (Organisations)","CREDIT","CONTRIBUTION","","","","$100.00 USD",100,-4.2,95.8,5800.65,"USD","hledger","hledger","writersperhour","Writers Per Hour","STRIPE","CREDITCARD",,"",,,
"2022-05-01T15:02:37","9b648ac6","5d5690df","Host Fee to Open Source Collective","DEBIT","HOST_FEE","","","","-$10.00 USD",-10,0,-10,5704.85,"USD","hledger","hledger","opensource","Open Source Collective",,,,"",,,
"2022-05-01T10:18:21","d96c37a7","7760aa73","Monthly contribution from Brandon Barker (Individuals)","CREDIT","CONTRIBUTION","","","","$2.00 USD",2,-0.36,1.64,5714.85,"USD","hledger","hledger","brandonbarker","Brandon Barker","STRIPE","CREDITCARD",,"",,,
"2022-05-01T10:18:21","04765c43","7760aa73","Host Fee to Open Source Collective","DEBIT","HOST_FEE","","","","-$0.20 USD",-0.2,0,-0.2,5713.21,"USD","hledger","hledger","opensource","Open Source Collective",,,,"",,,
"2022-05-01T10:17:15","707c2afa","ce11dec0","Monthly contribution from Tony Xiao (Individuals)","CREDIT","CONTRIBUTION","","","","$10.00 USD",10,-0.59,9.41,5713.41,"USD","hledger","hledger","tony-xiao1","Tony Xiao","STRIPE","CREDITCARD",,"",,,
"2022-05-01T10:17:15","60257768","ce11dec0","Host Fee to Open Source Collective","DEBIT","HOST_FEE","","","","-$1.00 USD",-1,0,-1,5704,"USD","hledger","hledger","opensource","Open Source Collective",,,,"",,,
"2022-05-01T10:15:49","cddd178c","d42c9ec0","Monthly contribution from Rishi Hyanki (Individuals)","CREDIT","CONTRIBUTION","","","","$2.00 USD",2,-0.36,1.64,5705,"USD","hledger","hledger","rhyanki","Rishi Hyanki","STRIPE","CREDITCARD",,"",,,
"2022-05-01T10:15:49","bcc59850","d42c9ec0","Host Fee to Open Source Collective","DEBIT","HOST_FEE","","","","-$0.20 USD",-0.2,0,-0.2,5703.36,"USD","hledger","hledger","opensource","Open Source Collective",,,,"",,,
"2022-05-01T05:10:33","e98623a6","0c8dc2fe","Monthly contribution from Frank (Individuals)","CREDIT","CONTRIBUTION","","","","$2.00 USD",2,-0.38,1.62,5703.56,"USD","hledger","hledger","guest-4c0726ae","Frank","STRIPE","CREDITCARD",,"",,,
"2022-05-01T05:10:33","421ab617","0c8dc2fe","Host Fee to Open Source Collective","DEBIT","HOST_FEE","","","","-$0.20 USD",-0.2,0,-0.2,5701.94,"USD","hledger","hledger","opensource","Open Source Collective",,,,"",,,
"2022-05-01T04:04:32","152917c9","d9f94547","Monthly contribution from MSATC (Individuals)","CREDIT","CONTRIBUTION","","","","$2.00 USD",2,-0.38,1.62,5702.14,"USD","hledger","hledger","msatc","MSATC","STRIPE","CREDITCARD",,"",,,
"2022-05-01T04:04:32","d0e93287","d9f94547","Host Fee to Open Source Collective","DEBIT","HOST_FEE","","","","-$0.20 USD",-0.2,0,-0.2,5700.52,"USD","hledger","hledger","opensource","Open Source Collective",,,,"",,,
"2022-05-01T00:14:25","445c7bc4","1601b2da","Monthly contribution from Michael Martinides (Individuals)","CREDIT","CONTRIBUTION","","","","$2.00 USD",2,-0.38,1.62,5700.72,"USD","hledger","hledger","michael-martinides","Michael Martinides","STRIPE","CREDITCARD",,"",,,
"2022-05-01T00:14:25","86f07402","1601b2da","Host Fee to Open Source Collective","DEBIT","HOST_FEE","","","","-$0.20 USD",-0.2,0,-0.2,5699.1,"USD","hledger","hledger","opensource","Open Source Collective",,,,"",,,
"2022-05-01T00:13:44","34056334","70cb6177","Monthly contribution from October Swimmer (Organisations)","CREDIT","CONTRIBUTION","","","","$100.00 USD",100,-3.2,96.8,5699.3,"USD","hledger","hledger","october-swimmer","October Swimmer",,,,"",,,
"2022-05-01T00:13:44","9ba020a6","70cb6177","Host Fee to Open Source Collective","DEBIT","HOST_FEE","","","","-$10.00 USD",-10,0,-10,5602.5,"USD","hledger","hledger","opensource","Open Source Collective",,,,"",,,
"2022-04-30T11:42:52","1ba4fad6","41f499ef","Monthly contribution from Richard Kelly (Individuals)","CREDIT","CONTRIBUTION","","","","$2.00 USD",2,-0.56,1.44,5612.5,"USD","hledger","hledger","richard-kelly","Richard Kelly","PAYPAL","SUBSCRIPTION",,"",,,
"2022-04-30T11:42:52","15bde9c0","41f499ef","Host Fee to Open Source Collective","DEBIT","HOST_FEE","","","","-$0.20 USD",-0.2,0,-0.2,5611.06,"USD","hledger","hledger","opensource","Open Source Collective",,,,"",,,
"2022-04-24T10:18:57","56424866","75644a16","Monthly contribution from Olsens Revision ApS (Individuals)","CREDIT","CONTRIBUTION","","","","$100.00 USD",100,-5.48,94.52,5611.26,"USD","hledger","hledger","olsensrevision","Olsens Revision ApS","PAYPAL","SUBSCRIPTION",,"",,,
"2022-04-24T10:18:57","d95351f5","75644a16","Host Fee to Open Source Collective","DEBIT","HOST_FEE","","","","-$10.00 USD",-10,0,-10,5516.74,"USD","hledger","hledger","opensource","Open Source Collective",,,,"",,,
"2022-04-23T11:11:38","c99496ce","0ba668db","Monthly contribution from Guest (Individuals)","CREDIT","CONTRIBUTION","","","","$2.00 USD",2,-0.59,1.41,5526.74,"USD","hledger","hledger","guest-d120c27f","Guest","PAYPAL","SUBSCRIPTION",,"",,,
"2022-04-23T11:11:37","31f39c98","0ba668db","Host Fee to Open Source Collective","DEBIT","HOST_FEE","","","","-$0.20 USD",-0.2,0,-0.2,5525.33,"USD","hledger","hledger","opensource","Open Source Collective",,,,"",,,
"2022-04-19T11:25:25","38a48a99","73e61437","Monthly contribution from APM Help (Organisations)","CREDIT","CONTRIBUTION","","","","$100.00 USD",100,-3.98,96.02,5525.53,"USD","hledger","hledger","apmhelp","APM Help","PAYPAL","SUBSCRIPTION",,"",,,
"2022-04-19T11:25:25","6824c094","73e61437","Host Fee to Open Source Collective","DEBIT","HOST_FEE","","","","-$10.00 USD",-10,0,-10,5429.51,"USD","hledger","hledger","opensource","Open Source Collective",,,,"",,,
"2022-04-12T20:00:38","281bfbee","6a28d226","Contribution to Support Ukraine","DEBIT","CONTRIBUTION","","","","-$500.00 USD",-500,0,-500,5439.51,"USD","hledger","hledger","support-ukraine","Support Ukraine","OPENCOLLECTIVE","COLLECTIVE",,"",,,
"2022-04-08T10:21:52","15ed735c","591fe54d","Monthly contribution from Targeted Organic Traffic (Individuals)","CREDIT","CONTRIBUTION","","","","$2.00 USD",2,-0.59,1.41,5939.51,"USD","hledger","hledger","targeted-organic-traffic","Targeted Organic Traffic","PAYPAL","SUBSCRIPTION",,"",,,
"2022-04-08T10:21:52","04e6992c","591fe54d","Host Fee to Open Source Collective","DEBIT","HOST_FEE","","","","-$0.20 USD",-0.2,0,-0.2,5938.1,"USD","hledger","hledger","opensource","Open Source Collective",,,,"",,,
"2022-04-07T12:38:13","53f1612e","b85958fd","Monthly contribution from Real Targeted Traffic (Individuals)","CREDIT","CONTRIBUTION","","","","$2.00 USD",2,-0.59,1.41,5938.3,"USD","hledger","hledger","seo25-com","Real Targeted Traffic","PAYPAL","SUBSCRIPTION",,"",,,
"2022-04-07T12:38:12","a7d3063f","b85958fd","Host Fee to Open Source Collective","DEBIT","HOST_FEE","","","","-$0.20 USD",-0.2,0,-0.2,5936.89,"USD","hledger","hledger","opensource","Open Source Collective",,,,"",,,
"2022-04-02T04:01:32","cad66e8a","c734a672","Monthly contribution from Brandon J Wong (Individuals)","CREDIT","CONTRIBUTION","","","","$2.00 USD",2,-0.38,1.62,5937.09,"USD","hledger","hledger","brandon-j-wong","Brandon J Wong",,,,"",,,
"2022-04-02T04:01:32","9bb46d69","c734a672","Host Fee to Open Source Collective","DEBIT","HOST_FEE","","","","-$0.20 USD",-0.2,0,-0.2,5935.47,"USD","hledger","hledger","opensource","Open Source Collective",,,,"",,,
"2022-04-02T02:15:24","aaa98278","e3f21dac","Monthly contribution from Jack Todaro (Individuals)","CREDIT","CONTRIBUTION","","","","$2.00 USD",2,-0.38,1.62,5935.67,"USD","hledger","hledger","jack-todaro","Jack Todaro","STRIPE","CREDITCARD",,"",,,
"2022-04-02T02:15:24","93d34da7","e3f21dac","Host Fee to Open Source Collective","DEBIT","HOST_FEE","","","","-$0.20 USD",-0.2,0,-0.2,5934.05,"USD","hledger","hledger","opensource","Open Source Collective",,,,"",,,
"2022-04-01T20:08:53","1967e528","ec34a91f","Monthly contribution from Ken Ewing (Individuals)","CREDIT","CONTRIBUTION","","","","$2.00 USD",2,-0.36,1.64,5934.25,"USD","hledger","hledger","ken-ewing","Ken Ewing","STRIPE","CREDITCARD",,"",,,
"2022-04-01T20:08:53","e792b5ef","ec34a91f","Host Fee to Open Source Collective","DEBIT","HOST_FEE","","","","-$0.20 USD",-0.2,0,-0.2,5932.61,"USD","hledger","hledger","opensource","Open Source Collective",,,,"",,,
"2022-04-01T14:25:33","6e80d8a3","dbcec381","Monthly contribution from Writers Per Hour (Organisations)","CREDIT","CONTRIBUTION","","","","$100.00 USD",100,-4.2,95.8,5932.81,"USD","hledger","hledger","writersperhour","Writers Per Hour","STRIPE","CREDITCARD",,"",,,
"2022-04-01T14:25:33","7b0d520c","dbcec381","Host Fee to Open Source Collective","DEBIT","HOST_FEE","","","","-$10.00 USD",-10,0,-10,5837.01,"USD","hledger","hledger","opensource","Open Source Collective",,,,"",,,
"2022-04-01T13:45:19","572b45a0","bc3b4869","Monthly contribution from James Blachly (Individuals)","CREDIT","CONTRIBUTION","","","","$2.00 USD",2,-0.36,1.64,5847.01,"USD","hledger","hledger","james-blachly","James Blachly","STRIPE","CREDITCARD",,"",,,
"2022-04-01T13:45:19","d8fcaae2","bc3b4869","Host Fee to Open Source Collective","DEBIT","HOST_FEE","","","","-$0.20 USD",-0.2,0,-0.2,5845.37,"USD","hledger","hledger","opensource","Open Source Collective",,,,"",,,
"2022-04-01T10:20:35","b019e8bd","49c3660d","Monthly contribution from Brandon Barker (Individuals)","CREDIT","CONTRIBUTION","","","","$2.00 USD",2,-0.36,1.64,5845.57,"USD","hledger","hledger","brandonbarker","Brandon Barker","STRIPE","CREDITCARD",,"",,,
"2022-04-01T10:20:35","737f69fa","49c3660d","Host Fee to Open Source Collective","DEBIT","HOST_FEE","","","","-$0.20 USD",-0.2,0,-0.2,5843.93,"USD","hledger","hledger","opensource","Open Source Collective",,,,"",,,
"2022-04-01T10:19:22","21a04b3d","2e4e6f80","Monthly contribution from Tony Xiao (Individuals)","CREDIT","CONTRIBUTION","","","","$10.00 USD",10,-0.59,9.41,5844.13,"USD","hledger","hledger","tony-xiao1","Tony Xiao","STRIPE","CREDITCARD",,"",,,
"2022-04-01T10:19:22","309de6aa","2e4e6f80","Host Fee to Open Source Collective","DEBIT","HOST_FEE","","","","-$1.00 USD",-1,0,-1,5834.72,"USD","hledger","hledger","opensource","Open Source Collective",,,,"",,,
"2022-04-01T10:15:48","350376b5","f30ec5ba","Monthly contribution from Rishi Hyanki (Individuals)","CREDIT","CONTRIBUTION","","","","$2.00 USD",2,-0.36,1.64,5835.72,"USD","hledger","hledger","rhyanki","Rishi Hyanki","STRIPE","CREDITCARD",,"",,,
"2022-04-01T10:15:48","10c36d8b","f30ec5ba","Host Fee to Open Source Collective","DEBIT","HOST_FEE","","","","-$0.20 USD",-0.2,0,-0.2,5834.08,"USD","hledger","hledger","opensource","Open Source Collective",,,,"",,,
"2022-04-01T04:19:42","561a9927","e086dcb6","Monthly contribution from Frank (Individuals)","CREDIT","CONTRIBUTION","","","","$2.00 USD",2,-0.38,1.62,5834.28,"USD","hledger","hledger","guest-4c0726ae","Frank","STRIPE","CREDITCARD",,"",,,
"2022-04-01T04:19:42","fe83a23d","e086dcb6","Host Fee to Open Source Collective","DEBIT","HOST_FEE","","","","-$0.20 USD",-0.2,0,-0.2,5832.66,"USD","hledger","hledger","opensource","Open Source Collective",,,,"",,,
"2022-04-01T03:08:45","ebba6572","26dd6075","Monthly contribution from MSATC (Individuals)","CREDIT","CONTRIBUTION","","","","$2.00 USD",2,-0.38,1.62,5832.86,"USD","hledger","hledger","msatc","MSATC","STRIPE","CREDITCARD",,"",,,
"2022-04-01T03:08:45","c109e5d7","26dd6075","Host Fee to Open Source Collective","DEBIT","HOST_FEE","","","","-$0.20 USD",-0.2,0,-0.2,5831.24,"USD","hledger","hledger","opensource","Open Source Collective",,,,"",,,
"2022-04-01T00:27:50","35a2e7b8","b66667bd","Monthly contribution from Michael Martinides (Individuals)","CREDIT","CONTRIBUTION","","","","$2.00 USD",2,-0.38,1.62,5831.44,"USD","hledger","hledger","michael-martinides","Michael Martinides","STRIPE","CREDITCARD",,"",,,
"2022-04-01T00:27:50","492c671e","b66667bd","Host Fee to Open Source Collective","DEBIT","HOST_FEE","","","","-$0.20 USD",-0.2,0,-0.2,5829.82,"USD","hledger","hledger","opensource","Open Source Collective",,,,"",,,
"2022-04-01T00:26:41","9deea75e","dd1c9259","Monthly contribution from October Swimmer (Organisations)","CREDIT","CONTRIBUTION","","","","$100.00 USD",100,-3.2,96.8,5830.02,"USD","hledger","hledger","october-swimmer","October Swimmer",,,,"",,,
"2022-04-01T00:26:41","5876812a","dd1c9259","Host Fee to Open Source Collective","DEBIT","HOST_FEE","","","","-$10.00 USD",-10,0,-10,5733.22,"USD","hledger","hledger","opensource","Open Source Collective",,,,"",,,
"2022-03-31T11:10:30","ed56e2ec","8c1716b9","Monthly contribution from Richard Kelly (Individuals)","CREDIT","CONTRIBUTION","","","","$2.00 USD",2,-0.56,1.44,5743.22,"USD","hledger","hledger","richard-kelly","Richard Kelly","PAYPAL","SUBSCRIPTION",,"",,,
"2022-03-31T11:10:30","d8f9abee","8c1716b9","Host Fee to Open Source Collective","DEBIT","HOST_FEE","","","","-$0.20 USD",-0.2,0,-0.2,5741.78,"USD","hledger","hledger","opensource","Open Source Collective",,,,"",,,
"2022-03-24T11:00:49","03721886","e1062d2b","Monthly contribution from Olsens Revision ApS (Individuals)","CREDIT","CONTRIBUTION","","","","$100.00 USD",100,-5.48,94.52,5741.98,"USD","hledger","hledger","olsensrevision","Olsens Revision ApS","PAYPAL","SUBSCRIPTION",,"",,,
"2022-03-24T11:00:48","64520d32","e1062d2b","Host Fee to Open Source Collective","DEBIT","HOST_FEE","","","","-$10.00 USD",-10,0,-10,5647.46,"USD","hledger","hledger","opensource","Open Source Collective",,,,"",,,
"2022-03-23T20:01:11","308969f8","4fb2f518","Monthly contribution from Guest (Individuals)","CREDIT","CONTRIBUTION","","","","$2.00 USD",2,-0.59,1.41,5657.46,"USD","hledger","hledger","guest-d120c27f","Guest","PAYPAL","SUBSCRIPTION",,"",,,
"2022-03-23T20:01:11","33c7c55c","4fb2f518","Host Fee to Open Source Collective","DEBIT","HOST_FEE","","","","-$0.20 USD",-0.2,0,-0.2,5656.05,"USD","hledger","hledger","opensource","Open Source Collective",,,,"",,,
"2022-03-19T11:11:53","378b18d4","d0480afc","Monthly contribution from APM Help (Organisations)","CREDIT","CONTRIBUTION","","","","$100.00 USD",100,-3.98,96.02,5656.25,"USD","hledger","hledger","apmhelp","APM Help","PAYPAL","SUBSCRIPTION",,"",,,
"2022-03-19T11:11:53","19bcfbef","d0480afc","Host Fee to Open Source Collective","DEBIT","HOST_FEE","","","","-$10.00 USD",-10,0,-10,5560.23,"USD","hledger","hledger","opensource","Open Source Collective",,,,"",,,
"2022-03-08T10:11:03","6962b9c5","7ba7550c","Monthly contribution from Targeted Organic Traffic (Individuals)","CREDIT","CONTRIBUTION","","","","$2.00 USD",2,-0.59,1.41,5570.23,"USD","hledger","hledger","targeted-organic-traffic","Targeted Organic Traffic","PAYPAL","SUBSCRIPTION",,"",,,
"2022-03-08T10:11:03","017fe2bc","7ba7550c","Host Fee to Open Source Collective","DEBIT","HOST_FEE","","","","-$0.20 USD",-0.2,0,-0.2,5568.82,"USD","hledger","hledger","opensource","Open Source Collective",,,,"",,,
"2022-03-07T12:15:43","e45af40e","7a9dae4b","Monthly contribution from Real Targeted Traffic (Individuals)","CREDIT","CONTRIBUTION","","","","$2.00 USD",2,-0.59,1.41,5569.02,"USD","hledger","hledger","seo25-com","Real Targeted Traffic","PAYPAL","SUBSCRIPTION",,"",,,
"2022-03-07T12:15:42","2d866954","7a9dae4b","Host Fee to Open Source Collective","DEBIT","HOST_FEE","","","","-$0.20 USD",-0.2,0,-0.2,5567.61,"USD","hledger","hledger","opensource","Open Source Collective",,,,"",,,
"2022-03-02T04:09:02","df171dff","62c91ba5","Monthly contribution from Brandon J Wong (Individuals)","CREDIT","CONTRIBUTION","","","","$2.00 USD",2,-0.38,1.62,5567.81,"USD","hledger","hledger","brandon-j-wong","Brandon J Wong",,,,"",,,
"2022-03-02T04:09:02","a718e1db","62c91ba5","Host Fee to Open Source Collective","DEBIT","HOST_FEE","","","","-$0.20 USD",-0.2,0,-0.2,5566.19,"USD","hledger","hledger","opensource","Open Source Collective",,,,"",,,
"2022-03-02T02:16:31","3d4f91f1","ffcb3b78","Monthly contribution from Jack Todaro (Individuals)","CREDIT","CONTRIBUTION","","","","$2.00 USD",2,-0.38,1.62,5566.39,"USD","hledger","hledger","jack-todaro","Jack Todaro","STRIPE","CREDITCARD",,"",,,
"2022-03-02T02:16:31","fa8d06e4","ffcb3b78","Host Fee to Open Source Collective","DEBIT","HOST_FEE","","","","-$0.20 USD",-0.2,0,-0.2,5564.77,"USD","hledger","hledger","opensource","Open Source Collective",,,,"",,,
"2022-03-01T20:04:14","36c6bfd7","57dee045","Monthly contribution from Ken Ewing (Individuals)","CREDIT","CONTRIBUTION","","","","$2.00 USD",2,-0.36,1.64,5564.97,"USD","hledger","hledger","ken-ewing","Ken Ewing","STRIPE","CREDITCARD",,"",,,
"2022-03-01T20:04:14","eb4e1d22","57dee045","Host Fee to Open Source Collective","DEBIT","HOST_FEE","","","","-$0.20 USD",-0.2,0,-0.2,5563.33,"USD","hledger","hledger","opensource","Open Source Collective",,,,"",,,
"2022-03-01T15:06:52","410bbf0d","5b7ee700","Monthly contribution from Writers Per Hour (Organisations)","CREDIT","CONTRIBUTION","","","","$100.00 USD",100,-4.2,95.8,5563.53,"USD","hledger","hledger","writersperhour","Writers Per Hour","STRIPE","CREDITCARD",,"",,,
"2022-03-01T15:06:52","9a8e0241","5b7ee700","Host Fee to Open Source Collective","DEBIT","HOST_FEE","","","","-$10.00 USD",-10,0,-10,5467.73,"USD","hledger","hledger","opensource","Open Source Collective",,,,"",,,
"2022-03-01T14:13:37","222550b3","6d87a02b","Monthly contribution from James Blachly (Individuals)","CREDIT","CONTRIBUTION","","","","$2.00 USD",2,-0.36,1.64,5477.73,"USD","hledger","hledger","james-blachly","James Blachly","STRIPE","CREDITCARD",,"",,,
"2022-03-01T14:13:37","82a40204","6d87a02b","Host Fee to Open Source Collective","DEBIT","HOST_FEE","","","","-$0.20 USD",-0.2,0,-0.2,5476.09,"USD","hledger","hledger","opensource","Open Source Collective",,,,"",,,
"2022-03-01T11:44:52","3ece3784","91a8319b","Monthly contribution from Olsens Revision ApS (Individuals)","CREDIT","CONTRIBUTION","","","","$100.00 USD",100,-5.48,94.52,5476.29,"USD","hledger","hledger","olsensrevision","Olsens Revision ApS","PAYPAL","SUBSCRIPTION",,"",,,
"2022-03-01T11:44:52","4c8d39b1","91a8319b","Host Fee to Open Source Collective","DEBIT","HOST_FEE","","","","-$10.00 USD",-10,0,-10,5381.77,"USD","hledger","hledger","opensource","Open Source Collective",,,,"",,,
"2022-03-01T11:07:07","27c1dccb","bfbad7e0","Monthly contribution from Brandon Barker (Individuals)","CREDIT","CONTRIBUTION","","","","$2.00 USD",2,-0.36,1.64,5391.77,"USD","hledger","hledger","brandonbarker","Brandon Barker","STRIPE","CREDITCARD",,"",,,
"2022-03-01T11:07:07","585a8c38","bfbad7e0","Host Fee to Open Source Collective","DEBIT","HOST_FEE","","","","-$0.20 USD",-0.2,0,-0.2,5390.13,"USD","hledger","hledger","opensource","Open Source Collective",,,,"",,,
"2022-03-01T11:06:19","255083f0","e78f8d98","Monthly contribution from Tony Xiao (Individuals)","CREDIT","CONTRIBUTION","","","","$10.00 USD",10,-0.59,9.41,5390.33,"USD","hledger","hledger","tony-xiao1","Tony Xiao","STRIPE","CREDITCARD",,"",,,
"2022-03-01T11:06:19","e496c134","e78f8d98","Host Fee to Open Source Collective","DEBIT","HOST_FEE","","","","-$1.00 USD",-1,0,-1,5380.92,"USD","hledger","hledger","opensource","Open Source Collective",,,,"",,,
"2022-03-01T11:04:49","0f0b6c5f","101b6982","Monthly contribution from Rishi Hyanki (Individuals)","CREDIT","CONTRIBUTION","","","","$2.00 USD",2,-0.36,1.64,5381.92,"USD","hledger","hledger","rhyanki","Rishi Hyanki","STRIPE","CREDITCARD",,"",,,
"2022-03-01T11:04:49","9e0e11c0","101b6982","Host Fee to Open Source Collective","DEBIT","HOST_FEE","","","","-$0.20 USD",-0.2,0,-0.2,5380.28,"USD","hledger","hledger","opensource","Open Source Collective",,,,"",,,
"2022-03-01T05:03:11","93a82ffa","1619d1cd","Monthly contribution from Frank (Individuals)","CREDIT","CONTRIBUTION","","","","$2.00 USD",2,-0.38,1.62,5380.48,"USD","hledger","hledger","guest-4c0726ae","Frank","STRIPE","CREDITCARD",,"",,,
"2022-03-01T05:03:11","58791992","1619d1cd","Host Fee to Open Source Collective","DEBIT","HOST_FEE","","","","-$0.20 USD",-0.2,0,-0.2,5378.86,"USD","hledger","hledger","opensource","Open Source Collective",,,,"",,,
"2022-03-01T03:10:30","9983760f","e3fc5cce","Monthly contribution from MSATC (Individuals)","CREDIT","CONTRIBUTION","","","","$2.00 USD",2,-0.38,1.62,5379.06,"USD","hledger","hledger","msatc","MSATC","STRIPE","CREDITCARD",,"",,,
"2022-03-01T03:10:30","2f742a85","e3fc5cce","Host Fee to Open Source Collective","DEBIT","HOST_FEE","","","","-$0.20 USD",-0.2,0,-0.2,5377.44,"USD","hledger","hledger","opensource","Open Source Collective",,,,"",,,
"2022-03-01T00:22:43","cc307131","5aa70bb0","Monthly contribution from Michael Martinides (Individuals)","CREDIT","CONTRIBUTION","","","","$2.00 USD",2,-0.38,1.62,5377.64,"USD","hledger","hledger","michael-martinides","Michael Martinides","STRIPE","CREDITCARD",,"",,,
"2022-03-01T00:22:43","4f6ee380","5aa70bb0","Host Fee to Open Source Collective","DEBIT","HOST_FEE","","","","-$0.20 USD",-0.2,0,-0.2,5376.02,"USD","hledger","hledger","opensource","Open Source Collective",,,,"",,,
"2022-03-01T00:21:30","3ce8c347","9403b023","Monthly contribution from October Swimmer (Organisations)","CREDIT","CONTRIBUTION","","","","$100.00 USD",100,-3.2,96.8,5376.22,"USD","hledger","hledger","october-swimmer","October Swimmer",,,,"",,,
"2022-03-01T00:21:30","d218d48a","9403b023","Host Fee to Open Source Collective","DEBIT","HOST_FEE","","","","-$10.00 USD",-10,0,-10,5279.42,"USD","hledger","hledger","opensource","Open Source Collective",,,,"",,,
"2022-02-28T13:08:37","22c125ec","13f6fb27","Monthly contribution from Richard Kelly (Individuals)","CREDIT","CONTRIBUTION","","","","$2.00 USD",2,-0.56,1.44,5289.42,"USD","hledger","hledger","richard-kelly","Richard Kelly","PAYPAL","SUBSCRIPTION",,"",,,
"2022-02-28T13:08:37","317a0539","13f6fb27","Host Fee to Open Source Collective","DEBIT","HOST_FEE","","","","-$0.20 USD",-0.2,0,-0.2,5287.98,"USD","hledger","hledger","opensource","Open Source Collective",,,,"",,,
"2022-02-19T10:05:53","fe0d6430","61085297","Monthly contribution from APM Help (Organisations)","CREDIT","CONTRIBUTION","","","","$100.00 USD",100,-3.98,96.02,5288.18,"USD","hledger","hledger","apmhelp","APM Help","PAYPAL","SUBSCRIPTION",,"",,,
"2022-02-19T10:05:53","c1ce0531","61085297","Host Fee to Open Source Collective","DEBIT","HOST_FEE","","","","-$10.00 USD",-10,0,-10,5192.16,"USD","hledger","hledger","opensource","Open Source Collective",,,,"",,,
"2022-02-08T11:53:47","3f74e367","6713ab89","Monthly contribution from Targeted Organic Traffic (Individuals)","CREDIT","CONTRIBUTION","","","","$2.00 USD",2,-0.59,1.41,5202.16,"USD","hledger","hledger","targeted-organic-traffic","Targeted Organic Traffic","PAYPAL","SUBSCRIPTION",,"",,,
"2022-02-08T11:53:47","7593375e","6713ab89","Host Fee to Open Source Collective","DEBIT","HOST_FEE","","","","-$0.20 USD",-0.2,0,-0.2,5200.75,"USD","hledger","hledger","opensource","Open Source Collective",,,,"",,,
"2022-02-07T10:55:43","35cdd3b6","6d8b11ee","Monthly contribution from Real Targeted Traffic (Individuals)","CREDIT","CONTRIBUTION","","","","$2.00 USD",2,-0.59,1.41,5200.95,"USD","hledger","hledger","seo25-com","Real Targeted Traffic","PAYPAL","SUBSCRIPTION",,"",,,
"2022-02-07T10:55:43","4f68c17a","6d8b11ee","Host Fee to Open Source Collective","DEBIT","HOST_FEE","","","","-$0.20 USD",-0.2,0,-0.2,5199.54,"USD","hledger","hledger","opensource","Open Source Collective",,,,"",,,
"2022-02-07T08:16:43","46581770","5eb9dd86","Monthly contribution from Frank (Individuals)","CREDIT","CONTRIBUTION","","","","$2.00 USD",2,-0.38,1.62,5199.74,"USD","hledger","hledger","guest-4c0726ae","Frank","STRIPE","CREDITCARD",,"",,,
"2022-02-07T08:16:43","940234e6","5eb9dd86","Host Fee to Open Source Collective","DEBIT","HOST_FEE","","","","-$0.20 USD",-0.2,0,-0.2,5198.12,"USD","hledger","hledger","opensource","Open Source Collective",,,,"",,,
"2022-02-02T03:09:21","6a5e236a","bd6f9d37","Monthly contribution from Brandon J Wong (Individuals)","CREDIT","CONTRIBUTION","","","","$2.00 USD",2,-0.38,1.62,5198.32,"USD","hledger","hledger","brandon-j-wong","Brandon J Wong",,,,"",,,
"2022-02-02T03:09:21","a287de24","bd6f9d37","Host Fee to Open Source Collective","DEBIT","HOST_FEE","","","","-$0.20 USD",-0.2,0,-0.2,5196.7,"USD","hledger","hledger","opensource","Open Source Collective",,,,"",,,
"2022-02-02T01:18:18","0ca3a6f4","4bf0aa51","Monthly contribution from Jack Todaro (Individuals)","CREDIT","CONTRIBUTION","","","","$2.00 USD",2,-0.38,1.62,5196.9,"USD","hledger","hledger","jack-todaro","Jack Todaro","STRIPE","CREDITCARD",,"",,,
"2022-02-02T01:18:18","8017e143","4bf0aa51","Host Fee to Open Source Collective","DEBIT","HOST_FEE","","","","-$0.20 USD",-0.2,0,-0.2,5195.28,"USD","hledger","hledger","opensource","Open Source Collective",,,,"",,,
"2022-02-01T18:14:05","b5f0ce39","b7e30ce8","Monthly contribution from Ken Ewing (Individuals)","CREDIT","CONTRIBUTION","","","","$2.00 USD",2,-0.36,1.64,5195.48,"USD","hledger","hledger","ken-ewing","Ken Ewing","STRIPE","CREDITCARD",,"",,,
"2022-02-01T18:14:05","88eb7be5","b7e30ce8","Host Fee to Open Source Collective","DEBIT","HOST_FEE","","","","-$0.20 USD",-0.2,0,-0.2,5193.84,"USD","hledger","hledger","opensource","Open Source Collective",,,,"",,,
"2022-02-01T13:13:49","9312db9e","4fe13072","Monthly contribution from Writers Per Hour (Organisations)","CREDIT","CONTRIBUTION","","","","$100.00 USD",100,-4.2,95.8,5194.04,"USD","hledger","hledger","writersperhour","Writers Per Hour","STRIPE","CREDITCARD",,"",,,
"2022-02-01T13:13:49","353cb016","4fe13072","Host Fee to Open Source Collective","DEBIT","HOST_FEE","","","","-$10.00 USD",-10,0,-10,5098.24,"USD","hledger","hledger","opensource","Open Source Collective",,,,"",,,
"2022-02-01T12:19:01","4e15cdfe","3ce0d166","Monthly contribution from James Blachly (Individuals)","CREDIT","CONTRIBUTION","","","","$2.00 USD",2,-0.36,1.64,5108.24,"USD","hledger","hledger","james-blachly","James Blachly","STRIPE","CREDITCARD",,"",,,
"2022-02-01T12:19:01","efd85bbd","3ce0d166","Host Fee to Open Source Collective","DEBIT","HOST_FEE","","","","-$0.20 USD",-0.2,0,-0.2,5106.6,"USD","hledger","hledger","opensource","Open Source Collective",,,,"",,,
"2022-02-01T12:03:27","9311efc9","782467aa","Monthly contribution from Paulo Makdisse (Individuals)","CREDIT","CONTRIBUTION","","","","$2.00 USD",2,-0.38,1.62,5106.8,"USD","hledger","hledger","paulo-makdisse","Paulo Makdisse","STRIPE","CREDITCARD",,"",,,
"2022-02-01T12:03:27","11c4ff1b","782467aa","Host Fee to Open Source Collective","DEBIT","HOST_FEE","","","","-$0.20 USD",-0.2,0,-0.2,5105.18,"USD","hledger","hledger","opensource","Open Source Collective",,,,"",,,
"2022-02-01T10:02:22","8bd4071f","38520a3f","Monthly contribution from Tony Xiao (Individuals)","CREDIT","CONTRIBUTION","","","","$10.00 USD",10,-0.59,9.41,5105.38,"USD","hledger","hledger","tony-xiao1","Tony Xiao","STRIPE","CREDITCARD",,"",,,
"2022-02-01T10:02:21","db224ce7","38520a3f","Host Fee to Open Source Collective","DEBIT","HOST_FEE","","","","-$1.00 USD",-1,0,-1,5095.97,"USD","hledger","hledger","opensource","Open Source Collective",,,,"",,,
"2022-02-01T09:17:20","7a06f324","97c5c24d","Monthly contribution from Brandon Barker (Individuals)","CREDIT","CONTRIBUTION","","","","$2.00 USD",2,-0.36,1.64,5096.97,"USD","hledger","hledger","brandonbarker","Brandon Barker","STRIPE","CREDITCARD",,"",,,
"2022-02-01T09:17:20","0336247b","97c5c24d","Host Fee to Open Source Collective","DEBIT","HOST_FEE","","","","-$0.20 USD",-0.2,0,-0.2,5095.33,"USD","hledger","hledger","opensource","Open Source Collective",,,,"",,,
"2022-02-01T09:15:39","4dfa4ad8","5fdd2c91","Monthly contribution from Rishi Hyanki (Individuals)","CREDIT","CONTRIBUTION","","","","$2.00 USD",2,-0.36,1.64,5095.53,"USD","hledger","hledger","rhyanki","Rishi Hyanki","STRIPE","CREDITCARD",,"",,,
"2022-02-01T09:15:39","f47ecf2e","5fdd2c91","Host Fee to Open Source Collective","DEBIT","HOST_FEE","","","","-$0.20 USD",-0.2,0,-0.2,5093.89,"USD","hledger","hledger","opensource","Open Source Collective",,,,"",,,
"2022-02-01T03:07:54","68ac9dd7","0cf11a6a","Monthly contribution from MSATC (Individuals)","CREDIT","CONTRIBUTION","","","","$2.00 USD",2,-0.38,1.62,5094.09,"USD","hledger","hledger","msatc","MSATC","STRIPE","CREDITCARD",,"",,,
"2022-02-01T03:07:54","dc4061df","0cf11a6a","Host Fee to Open Source Collective","DEBIT","HOST_FEE","","","","-$0.20 USD",-0.2,0,-0.2,5092.47,"USD","hledger","hledger","opensource","Open Source Collective",,,,"",,,
"2022-02-01T00:22:01","5f9d4131","5a781ed5","Monthly contribution from Michael Martinides (Individuals)","CREDIT","CONTRIBUTION","","","","$2.00 USD",2,-0.38,1.62,5092.67,"USD","hledger","hledger","michael-martinides","Michael Martinides","STRIPE","CREDITCARD",,"",,,
"2022-02-01T00:22:01","303cd340","5a781ed5","Host Fee to Open Source Collective","DEBIT","HOST_FEE","","","","-$0.20 USD",-0.2,0,-0.2,5091.05,"USD","hledger","hledger","opensource","Open Source Collective",,,,"",,,
"2022-02-01T00:20:31","449bc9f5","7116234b","Monthly contribution from October Swimmer (Organisations)","CREDIT","CONTRIBUTION","","","","$100.00 USD",100,-3.2,96.8,5091.25,"USD","hledger","hledger","october-swimmer","October Swimmer",,,,"",,,
"2022-02-01T00:20:31","f51f5f9e","7116234b","Host Fee to Open Source Collective","DEBIT","HOST_FEE","","","","-$10.00 USD",-10,0,-10,4994.45,"USD","hledger","hledger","opensource","Open Source Collective",,,,"",,,
"2022-01-31T11:44:43","417b136e","cd2f5c20","Monthly contribution from Richard Kelly (Individuals)","CREDIT","CONTRIBUTION","","","","$2.00 USD",2,-0.56,1.44,5004.45,"USD","hledger","hledger","richard-kelly","Richard Kelly","PAYPAL","SUBSCRIPTION",,"",,,
"2022-01-31T11:44:43","459fff99","cd2f5c20","Host Fee to Open Source Collective","DEBIT","HOST_FEE","","","","-$0.20 USD",-0.2,0,-0.2,5003.01,"USD","hledger","hledger","opensource","Open Source Collective",,,,"",,,
"2022-01-24T21:01:35","223c09cc","89393085","Expense from holmescharles - regression bounty","DEBIT","EXPENSE","","","","-$100.00 USD",-100,-0.25,-100.25,5003.21,"USD","hledger","hledger","holmescharles","holmescharles",,,"INVOICE","","PAYPAL",,
"2022-01-24T11:10:48","1a297f6c","036f6c6c","Monthly contribution from Olsens Revision ApS (Individuals)","CREDIT","CONTRIBUTION","","","","$100.00 USD",100,-5.48,94.52,5103.46,"USD","hledger","hledger","olsensrevision","Olsens Revision ApS","PAYPAL","SUBSCRIPTION",,"",,,
"2022-01-24T11:10:48","2afb869d","036f6c6c","Host Fee to Open Source Collective","DEBIT","HOST_FEE","","","","-$10.00 USD",-10,0,-10,5008.94,"USD","hledger","hledger","opensource","Open Source Collective",,,,"",,,
"2022-01-19T10:10:58","b4b2afb6","4e78dc3f","Monthly contribution from APM Help (Organisations)","CREDIT","CONTRIBUTION","","","","$100.00 USD",100,-3.98,96.02,5018.94,"USD","hledger","hledger","apmhelp","APM Help","PAYPAL","SUBSCRIPTION",,"",,,
"2022-01-19T10:10:58","0014f3d6","4e78dc3f","Host Fee to Open Source Collective","DEBIT","HOST_FEE","","","","-$10.00 USD",-10,0,-10,4922.92,"USD","hledger","hledger","opensource","Open Source Collective",,,,"",,,
"2022-01-08T11:58:46","399da1bb","3a73ed49","Monthly contribution from Targeted Organic Traffic (Individuals)","CREDIT","CONTRIBUTION","","","","$2.00 USD",2,-0.59,1.41,4932.92,"USD","hledger","hledger","targeted-organic-traffic","Targeted Organic Traffic","PAYPAL","SUBSCRIPTION",,"",,,
"2022-01-08T11:58:46","94e4ffd9","3a73ed49","Host Fee to Open Source Collective","DEBIT","HOST_FEE","","","","-$0.20 USD",-0.2,0,-0.2,4931.51,"USD","hledger","hledger","opensource","Open Source Collective",,,,"",,,
"2022-01-07T11:14:54","25c23122","0717b78b","Monthly contribution from Real Targeted Traffic (Individuals)","CREDIT","CONTRIBUTION","","","","$2.00 USD",2,-0.59,1.41,4931.71,"USD","hledger","hledger","seo25-com","Real Targeted Traffic","PAYPAL","SUBSCRIPTION",,"",,,
"2022-01-07T11:14:53","fb2147e9","0717b78b","Host Fee to Open Source Collective","DEBIT","HOST_FEE","","","","-$0.20 USD",-0.2,0,-0.2,4930.3,"USD","hledger","hledger","opensource","Open Source Collective",,,,"",,,
"2022-01-06T10:06:07","5ab5cfea","1c033143","Monthly contribution from Brandon J Wong (Individuals)","CREDIT","CONTRIBUTION","","","","$2.00 USD",2,-0.38,1.62,4930.5,"USD","hledger","hledger","brandon-j-wong","Brandon J Wong",,,,"",,,
"2022-01-06T10:06:07","6ddd0f56","1c033143","Host Fee to Open Source Collective","DEBIT","HOST_FEE","","","","-$0.20 USD",-0.2,0,-0.2,4928.88,"USD","hledger","hledger","opensource","Open Source Collective",,,,"",,,
"2022-01-06T08:07:26","96d0e285","f0386650","Monthly contribution from Ken Ewing (Individuals)","CREDIT","CONTRIBUTION","","","","$2.00 USD",2,-0.36,1.64,4929.08,"USD","hledger","hledger","ken-ewing","Ken Ewing","STRIPE","CREDITCARD",,"",,,
"2022-01-06T08:07:26","9fd64a50","f0386650","Host Fee to Open Source Collective","DEBIT","HOST_FEE","","","","-$0.20 USD",-0.2,0,-0.2,4927.44,"USD","hledger","hledger","opensource","Open Source Collective",,,,"",,,
"2022-01-06T01:17:45","48105222","ae197fc3","Monthly contribution from Writers Per Hour (Organisations)","CREDIT","CONTRIBUTION","","","","$100.00 USD",100,-4.2,95.8,4927.64,"USD","hledger","hledger","writersperhour","Writers Per Hour","STRIPE","CREDITCARD",,"",,,
"2022-01-06T01:17:44","190adf19","ae197fc3","Host Fee to Open Source Collective","DEBIT","HOST_FEE","","","","-$10.00 USD",-10,0,-10,4831.84,"USD","hledger","hledger","opensource","Open Source Collective",,,,"",,,
"2022-01-06T00:18:05","c40c456b","f0d8ac7e","Monthly contribution from James Blachly (Individuals)","CREDIT","CONTRIBUTION","","","","$2.00 USD",2,-0.36,1.64,4841.84,"USD","hledger","hledger","james-blachly","James Blachly","STRIPE","CREDITCARD",,"",,,
"2022-01-06T00:18:05","d871f57e","f0d8ac7e","Host Fee to Open Source Collective","DEBIT","HOST_FEE","","","","-$0.20 USD",-0.2,0,-0.2,4840.2,"USD","hledger","hledger","opensource","Open Source Collective",,,,"",,,
"2022-01-05T23:13:33","fcc4dae2","5795de60","Monthly contribution from Paulo Makdisse (Individuals)","CREDIT","CONTRIBUTION","","","","$2.00 USD",2,-0.38,1.62,4840.4,"USD","hledger","hledger","paulo-makdisse","Paulo Makdisse","STRIPE","CREDITCARD",,"",,,
"2022-01-05T23:13:33","2c15fe6e","5795de60","Host Fee to Open Source Collective","DEBIT","HOST_FEE","","","","-$0.20 USD",-0.2,0,-0.2,4838.78,"USD","hledger","hledger","opensource","Open Source Collective",,,,"",,,
"2022-01-05T20:16:37","6e7762d4","107990aa","Monthly contribution from Brandon Barker (Individuals)","CREDIT","CONTRIBUTION","","","","$2.00 USD",2,-0.36,1.64,4838.98,"USD","hledger","hledger","brandonbarker","Brandon Barker","STRIPE","CREDITCARD",,"",,,
"2022-01-05T20:16:37","a8006818","107990aa","Host Fee to Open Source Collective","DEBIT","HOST_FEE","","","","-$0.20 USD",-0.2,0,-0.2,4837.34,"USD","hledger","hledger","opensource","Open Source Collective",,,,"",,,
"2022-01-05T20:15:42","c20e43e6","e6e56635","Monthly contribution from Tony Xiao (Individuals)","CREDIT","CONTRIBUTION","","","","$10.00 USD",10,-0.59,9.41,4837.54,"USD","hledger","hledger","tony-xiao1","Tony Xiao","STRIPE","CREDITCARD",,"",,,
"2022-01-05T20:15:42","ba4fbfad","e6e56635","Host Fee to Open Source Collective","DEBIT","HOST_FEE","","","","-$1.00 USD",-1,0,-1,4828.13,"USD","hledger","hledger","opensource","Open Source Collective",,,,"",,,
"2022-01-05T20:13:12","a0433e9f","6bdbb96e","Monthly contribution from Rishi Hyanki (Individuals)","CREDIT","CONTRIBUTION","","","","$2.00 USD",2,-0.36,1.64,4829.13,"USD","hledger","hledger","rhyanki","Rishi Hyanki","STRIPE","CREDITCARD",,"",,,
"2022-01-05T20:13:12","ac007514","6bdbb96e","Host Fee to Open Source Collective","DEBIT","HOST_FEE","","","","-$0.20 USD",-0.2,0,-0.2,4827.49,"USD","hledger","hledger","opensource","Open Source Collective",,,,"",,,
"2022-01-05T20:05:36","c2f148fd","2ac1aa58","Monthly contribution from Jack Todaro (Individuals)","CREDIT","CONTRIBUTION","","","","$2.00 USD",2,-0.38,1.62,4827.69,"USD","hledger","hledger","jack-todaro","Jack Todaro","STRIPE","CREDITCARD",,"",,,
"2022-01-05T20:05:36","1f663dec","2ac1aa58","Host Fee to Open Source Collective","DEBIT","HOST_FEE","","","","-$0.20 USD",-0.2,0,-0.2,4826.07,"USD","hledger","hledger","opensource","Open Source Collective",,,,"",,,
"2022-01-05T12:08:03","290be4a0","89cdca25","Monthly contribution from MSATC (Individuals)","CREDIT","CONTRIBUTION","","","","$2.00 USD",2,-0.38,1.62,4826.27,"USD","hledger","hledger","msatc","MSATC","STRIPE","CREDITCARD",,"",,,
"2022-01-05T12:08:03","7965c74d","89cdca25","Host Fee to Open Source Collective","DEBIT","HOST_FEE","","","","-$0.20 USD",-0.2,0,-0.2,4824.65,"USD","hledger","hledger","opensource","Open Source Collective",,,,"",,,
"2022-01-05T11:04:22","f21202d9","8e461007","Yearly contribution from incognito","CREDIT","CONTRIBUTION","","","","$50.00 USD",50,-2.25,47.75,4824.85,"USD","hledger","hledger","incognito-6a1e7e79","incognito","STRIPE","CREDITCARD",,"",,,
"2022-01-05T11:04:22","d30d7135","8e461007","Host Fee to Open Source Collective","DEBIT","HOST_FEE","","","","-$5.00 USD",-5,0,-5,4777.1,"USD","hledger","hledger","opensource","Open Source Collective",,,,"",,,
"2022-01-05T10:08:39","d9d0a70d","6e143975","Monthly contribution from Gyula Weber (Individuals)","CREDIT","CONTRIBUTION","","","","$5.00 USD",5,-0.5,4.5,4782.1,"USD","hledger","hledger","gyula_weber","Gyula Weber","STRIPE","CREDITCARD",,"",,,
"2022-01-05T10:08:39","f0c9d125","6e143975","Host Fee to Open Source Collective","DEBIT","HOST_FEE","","","","-$0.50 USD",-0.5,0,-0.5,4777.6,"USD","hledger","hledger","opensource","Open Source Collective",,,,"",,,
"2022-01-05T08:17:21","aabdc0e9","33b7caca","Monthly contribution from Michael Martinides (Individuals)","CREDIT","CONTRIBUTION","","","","$2.00 USD",2,-0.38,1.62,4778.1,"USD","hledger","hledger","michael-martinides","Michael Martinides","STRIPE","CREDITCARD",,"",,,
"2022-01-05T08:17:21","fd689dd5","33b7caca","Host Fee to Open Source Collective","DEBIT","HOST_FEE","","","","-$0.20 USD",-0.2,0,-0.2,4776.48,"USD","hledger","hledger","opensource","Open Source Collective",,,,"",,,
"2022-01-05T08:16:37","94d83c9a","80e3bf8f","Monthly contribution from October Swimmer (Organisations)","CREDIT","CONTRIBUTION","","","","$100.00 USD",100,-3.2,96.8,4776.68,"USD","hledger","hledger","october-swimmer","October Swimmer",,,,"",,,
"2022-01-05T08:16:37","6baddbe7","80e3bf8f","Host Fee to Open Source Collective","DEBIT","HOST_FEE","","","","-$10.00 USD",-10,0,-10,4679.88,"USD","hledger","hledger","opensource","Open Source Collective",,,,"",,,
"2021-12-31T11:20:38","066d057f","386be46e","Monthly contribution from Richard Kelly (Individuals)","CREDIT","CONTRIBUTION","","","","$2.00 USD",2,-0.56,1.44,4689.88,"USD","hledger","hledger","richard-kelly","Richard Kelly","PAYPAL","SUBSCRIPTION",,"",,,
"2021-12-31T11:20:38","8c9be809","386be46e","Host Fee to Open Source Collective","DEBIT","HOST_FEE","","","","-$0.20 USD",-0.2,0,-0.2,4688.44,"USD","hledger","hledger","opensource","Open Source Collective",,,,"",,,
"2021-12-24T11:55:48","edbf1a89","bbe38e50","Monthly contribution from Olsens Revision ApS (Individuals)","CREDIT","CONTRIBUTION","","","","$100.00 USD",100,-5.48,94.52,4688.64,"USD","hledger","hledger","olsensrevision","Olsens Revision ApS","PAYPAL","SUBSCRIPTION",,"",,,
"2021-12-24T11:55:48","c4f74c86","bbe38e50","Host Fee to Open Source Collective","DEBIT","HOST_FEE","","","","-$10.00 USD",-10,0,-10,4594.12,"USD","hledger","hledger","opensource","Open Source Collective",,,,"",,,
"2021-12-19T10:13:23","eb7240e0","6aaed51f","Monthly contribution from APM Help (Organisations)","CREDIT","CONTRIBUTION","","","","$100.00 USD",100,-3.98,96.02,4604.12,"USD","hledger","hledger","apmhelp","APM Help","PAYPAL","SUBSCRIPTION",,"",,,
"2021-12-19T10:13:23","f094c89e","6aaed51f","Host Fee to Open Source Collective","DEBIT","HOST_FEE","","","","-$10.00 USD",-10,0,-10,4508.1,"USD","hledger","hledger","opensource","Open Source Collective",,,,"",,,
"2021-12-08T11:33:16","9a12bc34","93c9edfd","Monthly contribution from Targeted Organic Traffic (Individuals)","CREDIT","CONTRIBUTION","","","","$2.00 USD",2,-0.59,1.41,4518.1,"USD","hledger","hledger","targeted-organic-traffic","Targeted Organic Traffic","PAYPAL","SUBSCRIPTION",,"",,,
"2021-12-08T11:33:16","fd915066","93c9edfd","Host Fee to Open Source Collective","DEBIT","HOST_FEE","","","","-$0.20 USD",-0.2,0,-0.2,4516.69,"USD","hledger","hledger","opensource","Open Source Collective",,,,"",,,
"2021-12-07T10:37:15","0150e7b3","9c48d4c1","Monthly contribution from Real Targeted Traffic (Individuals)","CREDIT","CONTRIBUTION","","","","$2.00 USD",2,-0.59,1.41,4516.89,"USD","hledger","hledger","seo25-com","Real Targeted Traffic","PAYPAL","SUBSCRIPTION",,"",,,
"2021-12-07T10:37:15","da89e74a","9c48d4c1","Host Fee to Open Source Collective","DEBIT","HOST_FEE","","","","-$0.20 USD",-0.2,0,-0.2,4515.48,"USD","hledger","hledger","opensource","Open Source Collective",,,,"",,,
"2021-12-02T01:19:54","bf6079fe","1b2dacd3","Monthly contribution from Brandon J Wong (Individuals)","CREDIT","CONTRIBUTION","","","","$2.00 USD",2,-0.38,1.62,4515.68,"USD","hledger","hledger","brandon-j-wong","Brandon J Wong",,,,"",,,
"2021-12-02T01:19:54","0fbe4d83","1b2dacd3","Host Fee to Open Source Collective","DEBIT","HOST_FEE","","","","-$0.20 USD",-0.2,0,-0.2,4514.06,"USD","hledger","hledger","opensource","Open Source Collective",,,,"",,,
"2021-12-01T16:09:12","ac76ed98","a20e24ee","Monthly contribution from Richard Kelly (Individuals)","CREDIT","CONTRIBUTION","","","","$2.00 USD",2,-0.36,1.64,4514.26,"USD","hledger","hledger","richard-kelly","Richard Kelly","STRIPE","CREDITCARD",,"",,,
"2021-12-01T16:09:12","c590a842","a20e24ee","Host Fee to Open Source Collective","DEBIT","HOST_FEE","","","","-$0.20 USD",-0.2,0,-0.2,4512.62,"USD","hledger","hledger","opensource","Open Source Collective",,,,"",,,
"2021-12-01T16:06:27","9624f650","1018639d","Monthly contribution from MSATC (Individuals)","CREDIT","CONTRIBUTION","","","","$2.00 USD",2,-0.38,1.62,4512.82,"USD","hledger","hledger","msatc","MSATC","STRIPE","CREDITCARD",,"",,,
"2021-12-01T16:06:26","79a0410c","1018639d","Host Fee to Open Source Collective","DEBIT","HOST_FEE","","","","-$0.20 USD",-0.2,0,-0.2,4511.2,"USD","hledger","hledger","opensource","Open Source Collective",,,,"",,,
"2021-12-01T13:07:03","92796166","e614709b","Monthly contribution from Jack Todaro (Individuals)","CREDIT","CONTRIBUTION","","","","$2.00 USD",2,-0.38,1.62,4511.4,"USD","hledger","hledger","jack-todaro","Jack Todaro","STRIPE","CREDITCARD",,"",,,
"2021-12-01T13:07:03","0b87d3d6","e614709b","Host Fee to Open Source Collective","DEBIT","HOST_FEE","","","","-$0.20 USD",-0.2,0,-0.2,4509.78,"USD","hledger","hledger","opensource","Open Source Collective",,,,"",,,
"2021-12-01T12:06:52","cfebc403","5f5df9f0","Monthly contribution from James Blachly (Individuals)","CREDIT","CONTRIBUTION","","","","$2.00 USD",2,-0.36,1.64,4509.98,"USD","hledger","hledger","james-blachly","James Blachly","STRIPE","CREDITCARD",,"",,,
"2021-12-01T12:06:52","978be77b","5f5df9f0","Host Fee to Open Source Collective","DEBIT","HOST_FEE","","","","-$0.20 USD",-0.2,0,-0.2,4508.34,"USD","hledger","hledger","opensource","Open Source Collective",,,,"",,,
"2021-12-01T10:02:44","8d0acc2b","bb0718a4","Monthly contribution from HLO_APC (Individuals)","CREDIT","CONTRIBUTION","","","","$2.00 USD",2,-0.36,1.64,4508.54,"USD","hledger","hledger","hlo_apc","HLO_APC","STRIPE","CREDITCARD",,"",,,
"2021-12-01T10:02:44","953978da","bb0718a4","Host Fee to Open Source Collective","DEBIT","HOST_FEE","","","","-$0.20 USD",-0.2,0,-0.2,4506.9,"USD","hledger","hledger","opensource","Open Source Collective",,,,"",,,
"2021-12-01T09:11:36","a0c7a143","ea181797","Monthly contribution from October Swimmer (Organisations)","CREDIT","CONTRIBUTION","","","","$100.00 USD",100,-3.2,96.8,4507.1,"USD","hledger","hledger","october-swimmer","October Swimmer",,,,"",,,
"2021-12-01T09:11:36","1c99a75b","ea181797","Host Fee to Open Source Collective","DEBIT","HOST_FEE","","","","-$10.00 USD",-10,0,-10,4410.3,"USD","hledger","hledger","opensource","Open Source Collective",,,,"",,,
"2021-12-01T09:10:23","eb77d236","941b504b","Monthly contribution from Paulo Makdisse (Individuals)","CREDIT","CONTRIBUTION","","","","$2.00 USD",2,-0.38,1.62,4420.3,"USD","hledger","hledger","paulo-makdisse","Paulo Makdisse","STRIPE","CREDITCARD",,"",,,
"2021-12-01T09:10:23","ebb1f31b","941b504b","Host Fee to Open Source Collective","DEBIT","HOST_FEE","","","","-$0.20 USD",-0.2,0,-0.2,4418.68,"USD","hledger","hledger","opensource","Open Source Collective",,,,"",,,
"2021-12-01T07:17:58","e9c7d8c7","5d0bfee5","Monthly contribution from Tony Xiao (Individuals)","CREDIT","CONTRIBUTION","","","","$10.00 USD",10,-0.59,9.41,4418.88,"USD","hledger","hledger","tony-xiao1","Tony Xiao","STRIPE","CREDITCARD",,"",,,
"2021-12-01T07:17:58","4264741d","5d0bfee5","Host Fee to Open Source Collective","DEBIT","HOST_FEE","","","","-$1.00 USD",-1,0,-1,4409.47,"USD","hledger","hledger","opensource","Open Source Collective",,,,"",,,
"2021-12-01T06:12:32","fc79cf3d","961d1918","Monthly contribution from Rishi Hyanki (Individuals)","CREDIT","CONTRIBUTION","","","","$2.00 USD",2,-0.36,1.64,4410.47,"USD","hledger","hledger","rhyanki","Rishi Hyanki","STRIPE","CREDITCARD",,"",,,
"2021-12-01T06:12:32","9915b256","961d1918","Host Fee to Open Source Collective","DEBIT","HOST_FEE","","","","-$0.20 USD",-0.2,0,-0.2,4408.83,"USD","hledger","hledger","opensource","Open Source Collective",,,,"",,,
"2021-12-01T06:08:58","1921c9a8","9830d46d","Monthly contribution from Writers Per Hour (Organisations)","CREDIT","CONTRIBUTION","","","","$100.00 USD",100,-4.2,95.8,4409.03,"USD","hledger","hledger","writersperhour","Writers Per Hour","STRIPE","CREDITCARD",,"",,,
"2021-12-01T06:08:58","34f65ae8","9830d46d","Host Fee to Open Source Collective","DEBIT","HOST_FEE","","","","-$10.00 USD",-10,0,-10,4313.23,"USD","hledger","hledger","opensource","Open Source Collective",,,,"",,,
"2021-12-01T04:18:17","ed72b4fe","9e457bde","Monthly contribution from Michael Martinides (Individuals)","CREDIT","CONTRIBUTION","","","","$2.00 USD",2,-0.38,1.62,4323.23,"USD","hledger","hledger","michael-martinides","Michael Martinides","STRIPE","CREDITCARD",,"",,,
"2021-12-01T04:18:17","fccfab0f","9e457bde","Host Fee to Open Source Collective","DEBIT","HOST_FEE","","","","-$0.20 USD",-0.2,0,-0.2,4321.61,"USD","hledger","hledger","opensource","Open Source Collective",,,,"",,,
"2021-12-01T00:13:00","00285da2","c7657f0a","Monthly contribution from Brandon Barker (Individuals)","CREDIT","CONTRIBUTION","","","","$2.00 USD",2,-0.36,1.64,4321.81,"USD","hledger","hledger","brandonbarker","Brandon Barker","STRIPE","CREDITCARD",,"",,,
"2021-12-01T00:13:00","51611ee8","c7657f0a","Host Fee to Open Source Collective","DEBIT","HOST_FEE","","","","-$0.20 USD",-0.2,0,-0.2,4320.17,"USD","hledger","hledger","opensource","Open Source Collective",,,,"",,,
"2021-12-01T00:09:53","e285e564","88c36e72","Monthly contribution from Gyula Weber (Individuals)","CREDIT","CONTRIBUTION","","","","$5.00 USD",5,-0.5,4.5,4320.37,"USD","hledger","hledger","gyula_weber","Gyula Weber","STRIPE","CREDITCARD",,"",,,
"2021-12-01T00:09:53","4036a095","88c36e72","Host Fee to Open Source Collective","DEBIT","HOST_FEE","","","","-$0.50 USD",-0.5,0,-0.5,4315.87,"USD","hledger","hledger","opensource","Open Source Collective",,,,"",,,
"2021-11-30T11:29:28","2a2d7b8f","4819f56a","Yearly contribution from Damien Cassou","CREDIT","CONTRIBUTION","","","","$20.00 USD",20,-1.49,18.51,4316.37,"USD","hledger","hledger","damien-cassou","Damien Cassou","PAYPAL","SUBSCRIPTION",,"",,,
"2021-11-30T11:29:28","446c3a23","4819f56a","Host Fee to Open Source Collective","DEBIT","HOST_FEE","","","","-$2.00 USD",-2,0,-2,4297.86,"USD","hledger","hledger","opensource","Open Source Collective",,,,"",,,
"2021-11-28T19:40:50","8443c68f","4c6a0fbf","Monthly contribution from Ken Ewing (Individuals)","CREDIT","CONTRIBUTION","","","","$2.00 USD",2,-0.36,1.64,4299.86,"USD","hledger","hledger","ken-ewing","Ken Ewing","STRIPE","CREDITCARD",,"",,,
"2021-11-28T19:40:50","33850779","4c6a0fbf","Host Fee to Open Source Collective","DEBIT","HOST_FEE","","","","-$0.20 USD",-0.2,0,-0.2,4298.22,"USD","hledger","hledger","opensource","Open Source Collective",,,,"",,,
"2021-11-24T17:37:51","73e33fba","c5647b65","Monthly contribution from Olsens Revision ApS (Individuals)","CREDIT","CONTRIBUTION","","","","$100.00 USD",100,-5.48,94.52,4298.42,"USD","hledger","hledger","olsensrevision","Olsens Revision ApS","PAYPAL","SUBSCRIPTION",,"",,,
"2021-11-24T17:37:51","154c934a","c5647b65","Host Fee to Open Source Collective","DEBIT","HOST_FEE","","","","-$10.00 USD",-10,0,-10,4203.9,"USD","hledger","hledger","opensource","Open Source Collective",,,,"",,,
"2021-11-19T10:41:50","c2a1086f","124dbc31","Monthly contribution from APM Help (Organisations)","CREDIT","CONTRIBUTION","","","","$100.00 USD",100,-3.98,96.02,4213.9,"USD","hledger","hledger","apmhelp","APM Help","PAYPAL","SUBSCRIPTION",,"",,,
"2021-11-19T10:41:49","69f7f210","124dbc31","Host Fee to Open Source Collective","DEBIT","HOST_FEE","","","","-$10.00 USD",-10,0,-10,4117.88,"USD","hledger","hledger","opensource","Open Source Collective",,,,"",,,
"2021-11-15T07:02:27","d565e515","5bb06854","Expense from Romain Gehrig - Regression Bounty","DEBIT","EXPENSE","","","","-$100.00 USD",-100,-0.25,-100.25,4127.88,"USD","hledger","hledger","romain-gehrig","Romain Gehrig",,,"INVOICE","","PAYPAL",,
"2021-11-08T11:23:59","56a2f017","c03f45b3","Monthly contribution from Targeted Organic Traffic (Individuals)","CREDIT","CONTRIBUTION","","","","$2.00 USD",2,-0.59,1.41,4228.13,"USD","hledger","hledger","targeted-organic-traffic","Targeted Organic Traffic","PAYPAL","SUBSCRIPTION",,"",,,
"2021-11-08T11:23:59","3591939b","c03f45b3","Host Fee to Open Source Collective","DEBIT","HOST_FEE","","","","-$0.20 USD",-0.2,0,-0.2,4226.72,"USD","hledger","hledger","opensource","Open Source Collective",,,,"",,,
"2021-11-07T12:04:27","5d5d8a03","bbbec56e","Monthly contribution from Real Targeted Traffic (Individuals)","CREDIT","CONTRIBUTION","","","","$2.00 USD",2,-0.59,1.41,4226.92,"USD","hledger","hledger","seo25-com","Real Targeted Traffic","PAYPAL","SUBSCRIPTION",,"",,,
"2021-11-07T12:04:27","3fba7047","bbbec56e","Host Fee to Open Source Collective","DEBIT","HOST_FEE","","","","-$0.20 USD",-0.2,0,-0.2,4225.51,"USD","hledger","hledger","opensource","Open Source Collective",,,,"",,,
"2021-11-05T02:02:18","2b252d49","37a239ff","Expense from arc - Regression Bounty","DEBIT","EXPENSE","","","","-$100.00 USD",-100,-2,-102,4225.71,"USD","hledger","hledger","aarrcc","arc",,,"INVOICE","","PAYPAL",,
"2021-11-02T00:21:36","4d188d94","8eb8646d","Monthly contribution from Brandon J Wong (Individuals)","CREDIT","CONTRIBUTION","","","","$2.00 USD",2,-0.38,1.62,4327.71,"USD","hledger","hledger","brandon-j-wong","Brandon J Wong",,,,"",,,
"2021-11-02T00:21:36","461487b8","8eb8646d","Host Fee to Open Source Collective","DEBIT","HOST_FEE","","","","-$0.20 USD",-0.2,0,-0.2,4326.09,"USD","hledger","hledger","opensource","Open Source Collective",,,,"",,,
"2021-11-01T19:18:17","b83ed473","ba6c3af0","Monthly contribution from Writers Per Hour (Organisations)","CREDIT","CONTRIBUTION","","","","$100.00 USD",100,-4.2,95.8,4326.29,"USD","hledger","hledger","writersperhour","Writers Per Hour","STRIPE","CREDITCARD",,"",,,
"2021-11-01T19:18:17","624e4687","ba6c3af0","Host Fee to Open Source Collective","DEBIT","HOST_FEE","","","","-$10.00 USD",-10,0,-10,4230.49,"USD","hledger","hledger","opensource","Open Source Collective",,,,"",,,
"2021-11-01T18:16:57","610d5026","eb6375dc","Monthly contribution from James Blachly (Individuals)","CREDIT","CONTRIBUTION","","","","$2.00 USD",2,-0.36,1.64,4240.49,"USD","hledger","hledger","james-blachly","James Blachly","STRIPE","CREDITCARD",,"",,,
"2021-11-01T18:16:57","e618121f","eb6375dc","Host Fee to Open Source Collective","DEBIT","HOST_FEE","","","","-$0.20 USD",-0.2,0,-0.2,4238.85,"USD","hledger","hledger","opensource","Open Source Collective",,,,"",,,
"2021-11-01T17:13:28","e77fd746","7ea8053b","Monthly contribution from Paulo Makdisse (Individuals)","CREDIT","CONTRIBUTION","","","","$2.00 USD",2,-0.38,1.62,4239.05,"USD","hledger","hledger","paulo-makdisse","Paulo Makdisse","STRIPE","CREDITCARD",,"",,,
"2021-11-01T17:13:28","f7643e5f","7ea8053b","Host Fee to Open Source Collective","DEBIT","HOST_FEE","","","","-$0.20 USD",-0.2,0,-0.2,4237.43,"USD","hledger","hledger","opensource","Open Source Collective",,,,"",,,
"2021-11-01T15:23:18","d64c6d14","a084f13f","Monthly contribution from HLO_APC (Individuals)","CREDIT","CONTRIBUTION","","","","$2.00 USD",2,-0.36,1.64,4237.63,"USD","hledger","hledger","hlo_apc","HLO_APC","STRIPE","CREDITCARD",,"",,,
"2021-11-01T15:23:18","40320bf5","a084f13f","Host Fee to Open Source Collective","DEBIT","HOST_FEE","","","","-$0.20 USD",-0.2,0,-0.2,4235.99,"USD","hledger","hledger","opensource","Open Source Collective",,,,"",,,
"2021-11-01T14:23:06","38ad714a","211fd188","Monthly contribution from FinMasters (Organisations)","CREDIT","CONTRIBUTION","","","","$100.00 USD",100,-4.2,95.8,4236.19,"USD","hledger","hledger","finmasters","FinMasters","STRIPE","CREDITCARD",,"",,,
"2021-11-01T14:23:05","da2af6cb","211fd188","Host Fee to Open Source Collective","DEBIT","HOST_FEE","","","","-$10.00 USD",-10,0,-10,4140.39,"USD","hledger","hledger","opensource","Open Source Collective",,,,"",,,
"2021-11-01T14:10:54","b7251628","683933f5","Monthly contribution from Brandon Barker (Individuals)","CREDIT","CONTRIBUTION","","","","$2.00 USD",2,-0.36,1.64,4150.39,"USD","hledger","hledger","brandonbarker","Brandon Barker","STRIPE","CREDITCARD",,"",,,
"2021-11-01T14:10:54","8295964c","683933f5","Host Fee to Open Source Collective","DEBIT","HOST_FEE","","","","-$0.20 USD",-0.2,0,-0.2,4148.75,"USD","hledger","hledger","opensource","Open Source Collective",,,,"",,,
"2021-11-01T14:09:58","800bf5d6","370c4360","Monthly contribution from Tony Xiao (Individuals)","CREDIT","CONTRIBUTION","","","","$10.00 USD",10,-0.59,9.41,4148.95,"USD","hledger","hledger","tony-xiao1","Tony Xiao","STRIPE","CREDITCARD",,"",,,
"2021-11-01T14:09:58","6073cb85","370c4360","Host Fee to Open Source Collective","DEBIT","HOST_FEE","","","","-$1.00 USD",-1,0,-1,4139.54,"USD","hledger","hledger","opensource","Open Source Collective",,,,"",,,
"2021-11-01T14:07:32","ff0d739f","722cc57b","Monthly contribution from Rishi Hyanki (Individuals)","CREDIT","CONTRIBUTION","","","","$2.00 USD",2,-0.36,1.64,4140.54,"USD","hledger","hledger","rhyanki","Rishi Hyanki","STRIPE","CREDITCARD",,"",,,
"2021-11-01T14:07:32","72428266","722cc57b","Host Fee to Open Source Collective","DEBIT","HOST_FEE","","","","-$0.20 USD",-0.2,0,-0.2,4138.9,"USD","hledger","hledger","opensource","Open Source Collective",,,,"",,,
"2021-11-01T13:14:04","1634bb3a","107fca7c","Monthly contribution from Jack Todaro (Individuals)","CREDIT","CONTRIBUTION","","","","$2.00 USD",2,-0.38,1.62,4139.1,"USD","hledger","hledger","jack-todaro","Jack Todaro","STRIPE","CREDITCARD",,"",,,
"2021-11-01T13:14:04","d57714ff","107fca7c","Host Fee to Open Source Collective","DEBIT","HOST_FEE","","","","-$0.20 USD",-0.2,0,-0.2,4137.48,"USD","hledger","hledger","opensource","Open Source Collective",,,,"",,,
"2021-11-01T05:10:08","0535e33c","2e7e221a","Monthly contribution from Richard Kelly (Individuals)","CREDIT","CONTRIBUTION","","","","$2.00 USD",2,-0.36,1.64,4137.68,"USD","hledger","hledger","richard-kelly","Richard Kelly","STRIPE","CREDITCARD",,"",,,
"2021-11-01T05:10:08","64759eec","2e7e221a","Host Fee to Open Source Collective","DEBIT","HOST_FEE","","","","-$0.20 USD",-0.2,0,-0.2,4136.04,"USD","hledger","hledger","opensource","Open Source Collective",,,,"",,,
"2021-11-01T04:16:24","e57ebe49","c4b7fd18","Monthly contribution from MSATC (Individuals)","CREDIT","CONTRIBUTION","","","","$2.00 USD",2,-0.38,1.62,4136.24,"USD","hledger","hledger","msatc","MSATC","STRIPE","CREDITCARD",,"",,,
"2021-11-01T04:16:24","dfb1b80b","c4b7fd18","Host Fee to Open Source Collective","DEBIT","HOST_FEE","","","","-$0.20 USD",-0.2,0,-0.2,4134.62,"USD","hledger","hledger","opensource","Open Source Collective",,,,"",,,
"2021-11-01T02:10:21","f9013b28","ee490a5a","Monthly contribution from Gyula Weber (Individuals)","CREDIT","CONTRIBUTION","","","","$5.00 USD",5,-0.5,4.5,4134.82,"USD","hledger","hledger","gyula_weber","Gyula Weber","STRIPE","CREDITCARD",,"",,,
"2021-11-01T02:10:21","ac4c5c1f","ee490a5a","Host Fee to Open Source Collective","DEBIT","HOST_FEE","","","","-$0.50 USD",-0.5,0,-0.5,4130.32,"USD","hledger","hledger","opensource","Open Source Collective",,,,"",,,
"2021-11-01T01:03:19","e09e2191","2b7de276","Monthly contribution from Michael Martinides (Individuals)","CREDIT","CONTRIBUTION","","","","$2.00 USD",2,-0.38,1.62,4130.82,"USD","hledger","hledger","michael-martinides","Michael Martinides","STRIPE","CREDITCARD",,"",,,
"2021-11-01T01:03:19","131b6712","2b7de276","Host Fee to Open Source Collective","DEBIT","HOST_FEE","","","","-$0.20 USD",-0.2,0,-0.2,4129.2,"USD","hledger","hledger","opensource","Open Source Collective",,,,"",,,
"2021-11-01T00:21:19","c7d35ca5","334f1a51","Monthly contribution from October Swimmer (Organisations)","CREDIT","CONTRIBUTION","","","","$100.00 USD",100,-3.2,96.8,4129.4,"USD","hledger","hledger","october-swimmer","October Swimmer",,,,"",,,
"2021-11-01T00:21:19","9d06cc6f","334f1a51","Host Fee to Open Source Collective","DEBIT","HOST_FEE","","","","-$10.00 USD",-10,0,-10,4032.6,"USD","hledger","hledger","opensource","Open Source Collective",,,,"",,,
"2021-10-21T10:18:21","b04ca9cd","ed52160b","Monthly contribution from ilmaiskierroksia.lv (Individuals)","CREDIT","CONTRIBUTION","","","","$2.00 USD",2,-0.59,1.41,4042.6,"USD","hledger","hledger","ilmaiskierroksia-lv","ilmaiskierroksia.lv","PAYPAL","SUBSCRIPTION",,"",,,
"2021-10-21T10:18:21","4d2a692b","ed52160b","Host Fee to Open Source Collective","DEBIT","HOST_FEE","","","","-$0.20 USD",-0.2,0,-0.2,4041.19,"USD","hledger","hledger","opensource","Open Source Collective",,,,"",,,
"2021-10-19T10:09:22","1d93a1f5","131e7440","Monthly contribution from APM Help (Organisations)","CREDIT","CONTRIBUTION","","","","$100.00 USD",100,-3.98,96.02,4041.39,"USD","hledger","hledger","apmhelp","APM Help","PAYPAL","SUBSCRIPTION",,"",,,
"2021-10-19T10:09:22","fefd9264","131e7440","Host Fee to Open Source Collective","DEBIT","HOST_FEE","","","","-$10.00 USD",-10,0,-10,3945.37,"USD","hledger","hledger","opensource","Open Source Collective",,,,"",,,
"2021-10-17T20:56:58","6af44341","7c563358","Expense from David D Lowe - Regression bounty","DEBIT","EXPENSE","","","","-$100.00 USD",-100,-0.87,-100.87,3955.37,"USD","hledger","hledger","david-d-lowe","David D Lowe",,,"INVOICE","","BANK_ACCOUNT",,
"2021-10-08T14:25:49","d86fc8b8","a1b8f4df","Monthly contribution from Targeted Organic Traffic (Individuals)","CREDIT","CONTRIBUTION","","","","$2.00 USD",2,-0.59,1.41,4056.24,"USD","hledger","hledger","targeted-organic-traffic","Targeted Organic Traffic","PAYPAL","SUBSCRIPTION",,"",,,
"2021-10-08T14:25:48","f78041c1","a1b8f4df","Host Fee to Open Source Collective","DEBIT","HOST_FEE","","","","-$0.20 USD",-0.2,0,-0.2,4054.83,"USD","hledger","hledger","opensource","Open Source Collective",,,,"",,,
"2021-10-08T00:27:51","177a30e4","d1930561","Monthly contribution from Real Targeted Traffic (Individuals)","CREDIT","CONTRIBUTION","","","","$2.00 USD",2,-0.59,1.41,4055.03,"USD","hledger","hledger","seo25-com","Real Targeted Traffic","PAYPAL","SUBSCRIPTION",,"",,,
"2021-10-08T00:27:51","7acb7d8f","d1930561","Host Fee to Open Source Collective","DEBIT","HOST_FEE","","","","-$0.20 USD",-0.2,0,-0.2,4053.62,"USD","hledger","hledger","opensource","Open Source Collective",,,,"",,,
"2021-10-02T01:17:03","7ad19f21","d36cd41c","Monthly contribution from Brandon J Wong (Individuals)","CREDIT","CONTRIBUTION","","","","$2.00 USD",2,-0.38,1.62,4053.82,"USD","hledger","hledger","brandon-j-wong","Brandon J Wong",,,,"",,,
"2021-10-02T01:17:03","6213fd2f","d36cd41c","Host Fee to Open Source Collective","DEBIT","HOST_FEE","","","","-$0.20 USD",-0.2,0,-0.2,4052.2,"USD","hledger","hledger","opensource","Open Source Collective",,,,"",,,
"2021-10-01T20:18:31","78515ea4","95f36f12","Monthly contribution from Writers Per Hour (Organisations)","CREDIT","CONTRIBUTION","","","","$100.00 USD",100,-4.2,95.8,4052.4,"USD","hledger","hledger","writersperhour","Writers Per Hour","STRIPE","CREDITCARD",,"",,,
"2021-10-01T20:18:30","6d4450e1","95f36f12","Host Fee to Open Source Collective","DEBIT","HOST_FEE","","","","-$10.00 USD",-10,0,-10,3956.6,"USD","hledger","hledger","opensource","Open Source Collective",,,,"",,,
"2021-10-01T19:12:39","1362b4e8","f1598d5a","Monthly contribution from James Blachly (Individuals)","CREDIT","CONTRIBUTION","","","","$2.00 USD",2,-0.36,1.64,3966.6,"USD","hledger","hledger","james-blachly","James Blachly","STRIPE","CREDITCARD",,"",,,
"2021-10-01T19:12:39","42724f57","f1598d5a","Host Fee to Open Source Collective","DEBIT","HOST_FEE","","","","-$0.20 USD",-0.2,0,-0.2,3964.96,"USD","hledger","hledger","opensource","Open Source Collective",,,,"",,,
"2021-10-01T18:12:14","fadf23fe","4cc91dcf","Monthly contribution from Paulo Makdisse (Individuals)","CREDIT","CONTRIBUTION","","","","$2.00 USD",2,-0.38,1.62,3965.16,"USD","hledger","hledger","paulo-makdisse","Paulo Makdisse","STRIPE","CREDITCARD",,"",,,
"2021-10-01T18:12:14","521618d8","4cc91dcf","Host Fee to Open Source Collective","DEBIT","HOST_FEE","","","","-$0.20 USD",-0.2,0,-0.2,3963.54,"USD","hledger","hledger","opensource","Open Source Collective",,,,"",,,
"2021-10-01T16:14:12","4c6008aa","a01acc26","Monthly contribution from HLO_APC (Individuals)","CREDIT","CONTRIBUTION","","","","$2.00 USD",2,-0.36,1.64,3963.74,"USD","hledger","hledger","hlo_apc","HLO_APC","STRIPE","CREDITCARD",,"",,,
"2021-10-01T16:14:12","89de0e76","a01acc26","Host Fee to Open Source Collective","DEBIT","HOST_FEE","","","","-$0.20 USD",-0.2,0,-0.2,3962.1,"USD","hledger","hledger","opensource","Open Source Collective",,,,"",,,
"2021-10-01T15:18:21","edb65773","49e62f3d","Monthly contribution from FinMasters (Organisations)","CREDIT","CONTRIBUTION","","","","$100.00 USD",100,-4.2,95.8,3962.3,"USD","hledger","hledger","finmasters","FinMasters","STRIPE","CREDITCARD",,"",,,
"2021-10-01T15:18:21","a55b0d6b","49e62f3d","Host Fee to Open Source Collective","DEBIT","HOST_FEE","","","","-$10.00 USD",-10,0,-10,3866.5,"USD","hledger","hledger","opensource","Open Source Collective",,,,"",,,
"2021-10-01T14:18:10","234c69c5","81edfac8","Monthly contribution from Brandon Barker (Individuals)","CREDIT","CONTRIBUTION","","","","$2.00 USD",2,-0.36,1.64,3876.5,"USD","hledger","hledger","brandonbarker","Brandon Barker","STRIPE","CREDITCARD",,"",,,
"2021-10-01T14:18:09","78720157","81edfac8","Host Fee to Open Source Collective","DEBIT","HOST_FEE","","","","-$0.20 USD",-0.2,0,-0.2,3874.86,"USD","hledger","hledger","opensource","Open Source Collective",,,,"",,,
"2021-10-01T14:17:18","8f839f2d","a4d4f8a9","Monthly contribution from Tony Xiao (Individuals)","CREDIT","CONTRIBUTION","","","","$10.00 USD",10,-0.59,9.41,3875.06,"USD","hledger","hledger","tony-xiao1","Tony Xiao","STRIPE","CREDITCARD",,"",,,
"2021-10-01T14:17:18","dfd2e41c","a4d4f8a9","Host Fee to Open Source Collective","DEBIT","HOST_FEE","","","","-$1.00 USD",-1,0,-1,3865.65,"USD","hledger","hledger","opensource","Open Source Collective",,,,"",,,
"2021-10-01T14:14:45","d3364e2d","fd5fbe1b","Monthly contribution from Rishi Hyanki (Individuals)","CREDIT","CONTRIBUTION","","","","$2.00 USD",2,-0.36,1.64,3866.65,"USD","hledger","hledger","rhyanki","Rishi Hyanki","STRIPE","CREDITCARD",,"",,,
"2021-10-01T14:14:44","d88f06f6","fd5fbe1b","Host Fee to Open Source Collective","DEBIT","HOST_FEE","","","","-$0.20 USD",-0.2,0,-0.2,3865.01,"USD","hledger","hledger","opensource","Open Source Collective",,,,"",,,
"2021-10-01T14:07:16","ae862b76","47394626","Monthly contribution from Jack Todaro (Individuals)","CREDIT","CONTRIBUTION","","","","$2.00 USD",2,-0.38,1.62,3865.21,"USD","hledger","hledger","jack-todaro","Jack Todaro","STRIPE","CREDITCARD",,"",,,
"2021-10-01T14:07:16","c0cd12c4","47394626","Host Fee to Open Source Collective","DEBIT","HOST_FEE","","","","-$0.20 USD",-0.2,0,-0.2,3863.59,"USD","hledger","hledger","opensource","Open Source Collective",,,,"",,,
"2021-10-01T05:12:50","56a89a15","d1ca90ed","Monthly contribution from Richard Kelly (Individuals)","CREDIT","CONTRIBUTION","","","","$2.00 USD",2,-0.36,1.64,3863.79,"USD","hledger","hledger","richard-kelly","Richard Kelly","STRIPE","CREDITCARD",,"",,,
"2021-10-01T05:12:49","95442359","d1ca90ed","Host Fee to Open Source Collective","DEBIT","HOST_FEE","","","","-$0.20 USD",-0.2,0,-0.2,3862.15,"USD","hledger","hledger","opensource","Open Source Collective",,,,"",,,
"2021-10-01T05:04:23","db0e15e5","8bfedc1f","Monthly contribution from MSATC (Individuals)","CREDIT","CONTRIBUTION","","","","$2.00 USD",2,-0.38,1.62,3862.35,"USD","hledger","hledger","msatc","MSATC","STRIPE","CREDITCARD",,"",,,
"2021-10-01T05:04:23","3d9f6877","8bfedc1f","Host Fee to Open Source Collective","DEBIT","HOST_FEE","","","","-$0.20 USD",-0.2,0,-0.2,3860.73,"USD","hledger","hledger","opensource","Open Source Collective",,,,"",,,
"2021-10-01T02:15:08","c82f81eb","3cc4fe6c","Monthly contribution from Gyula Weber (Individuals)","CREDIT","CONTRIBUTION","","","","$5.00 USD",5,-0.5,4.5,3860.93,"USD","hledger","hledger","gyula_weber","Gyula Weber","STRIPE","CREDITCARD",,"",,,
"2021-10-01T02:15:08","18440605","3cc4fe6c","Host Fee to Open Source Collective","DEBIT","HOST_FEE","","","","-$0.50 USD",-0.5,0,-0.5,3856.43,"USD","hledger","hledger","opensource","Open Source Collective",,,,"",,,
"2021-10-01T01:02:31","aa0d0d0b","3204f6d5","Monthly contribution from Michael Martinides (Individuals)","CREDIT","CONTRIBUTION","","","","$2.00 USD",2,-0.38,1.62,3856.93,"USD","hledger","hledger","michael-martinides","Michael Martinides","STRIPE","CREDITCARD",,"",,,
"2021-10-01T01:02:31","83b0a063","3204f6d5","Host Fee to Open Source Collective","DEBIT","HOST_FEE","","","","-$0.20 USD",-0.2,0,-0.2,3855.31,"USD","hledger","hledger","opensource","Open Source Collective",,,,"",,,
"2021-10-01T01:01:30","4132ee2f","0421f701","Monthly contribution from October Swimmer (Organisations)","CREDIT","CONTRIBUTION","","","","$100.00 USD",100,-3.2,96.8,3855.51,"USD","hledger","hledger","october-swimmer","October Swimmer",,,,"",,,
"2021-10-01T01:01:30","c8cbaa2e","0421f701","Host Fee to Open Source Collective","DEBIT","HOST_FEE","","","","-$10.00 USD",-10,0,-10,3758.71,"USD","hledger","hledger","opensource","Open Source Collective",,,,"",,,
"2021-09-19T11:42:30","10273771","cd3da788","Monthly contribution from APM Help (Organisations)","CREDIT","CONTRIBUTION","","","","$100.00 USD",100,-3.98,96.02,3768.71,"USD","hledger","hledger","apmhelp","APM Help","PAYPAL","SUBSCRIPTION",,"",,,
"2021-09-19T11:42:30","affa70d4","cd3da788","Host Fee to Open Source Collective","DEBIT","HOST_FEE","","","","-$10.00 USD",-10,0,-10,3672.69,"USD","hledger","hledger","opensource","Open Source Collective",,,,"",,,
"2021-09-04T18:55:42","a7c55828","8387d5d6","Contribution from David Heijkamp","CREDIT","CONTRIBUTION","","","","$50.00 USD",50,-2.25,47.75,3682.69,"USD","hledger","hledger","guest-f1fc70f8","David Heijkamp","STRIPE","CREDITCARD",,"",,,
"2021-09-04T18:55:42","dd9f83fd","8387d5d6","Host Fee to Open Source Collective","DEBIT","HOST_FEE","","","","-$5.00 USD",-5,0,-5,3634.94,"USD","hledger","hledger","opensource","Open Source Collective",,,,"",,,
"2021-09-02T02:18:09","07ce11af","f8ac6bbe","Monthly contribution from Brandon J Wong (Individuals)","CREDIT","CONTRIBUTION","","","","$2.00 USD",2,-0.38,1.62,3639.94,"USD","hledger","hledger","brandon-j-wong","Brandon J Wong",,,,"",,,
"2021-09-02T02:18:09","7aa77d3e","f8ac6bbe","Host Fee to Open Source Collective","DEBIT","HOST_FEE","","","","-$0.20 USD",-0.2,0,-0.2,3638.32,"USD","hledger","hledger","opensource","Open Source Collective",,,,"",,,
"2021-09-01T21:19:19","06ec69e2","4c53364f","Monthly contribution from Writers Per Hour (Organisations)","CREDIT","CONTRIBUTION","","","","$100.00 USD",100,-4.2,95.8,3638.52,"USD","hledger","hledger","writersperhour","Writers Per Hour","STRIPE","CREDITCARD",,"",,,
"2021-09-01T21:19:19","cdb7b815","4c53364f","Host Fee to Open Source Collective","DEBIT","HOST_FEE","","","","-$10.00 USD",-10,0,-10,3542.72,"USD","hledger","hledger","opensource","Open Source Collective",,,,"",,,
"2021-09-01T20:15:37","e9c3af2e","69bbdc99","Monthly contribution from James Blachly (Individuals)","CREDIT","CONTRIBUTION","","","","$2.00 USD",2,-0.36,1.64,3552.72,"USD","hledger","hledger","james-blachly","James Blachly","STRIPE","CREDITCARD",,"",,,
"2021-09-01T20:15:37","6939f28c","69bbdc99","Host Fee to Open Source Collective","DEBIT","HOST_FEE","","","","-$0.20 USD",-0.2,0,-0.2,3551.08,"USD","hledger","hledger","opensource","Open Source Collective",,,,"",,,
"2021-09-01T19:09:14","c9e695d7","f1c772aa","Monthly contribution from Paulo Makdisse (Individuals)","CREDIT","CONTRIBUTION","","","","$2.00 USD",2,-0.38,1.62,3551.28,"USD","hledger","hledger","paulo-makdisse","Paulo Makdisse","STRIPE","CREDITCARD",,"",,,
"2021-09-01T19:09:14","6549c2ee","f1c772aa","Host Fee to Open Source Collective","DEBIT","HOST_FEE","","","","-$0.20 USD",-0.2,0,-0.2,3549.66,"USD","hledger","hledger","opensource","Open Source Collective",,,,"",,,
"2021-09-01T17:09:31","565b6e27","19e603e3","Monthly contribution from HLO_APC (Individuals)","CREDIT","CONTRIBUTION","","","","$2.00 USD",2,-0.36,1.64,3549.86,"USD","hledger","hledger","hlo_apc","HLO_APC","STRIPE","CREDITCARD",,"",,,
"2021-09-01T17:09:31","09f5636b","19e603e3","Host Fee to Open Source Collective","DEBIT","HOST_FEE","","","","-$0.20 USD",-0.2,0,-0.2,3548.22,"USD","hledger","hledger","opensource","Open Source Collective",,,,"",,,
"2021-09-01T16:14:04","05f4e4aa","af4c57f3","Monthly contribution from FinMasters (Organisations)","CREDIT","CONTRIBUTION","","","","$100.00 USD",100,-4.2,95.8,3548.42,"USD","hledger","hledger","finmasters","FinMasters","STRIPE","CREDITCARD",,"",,,
"2021-09-01T16:14:04","47044af1","af4c57f3","Host Fee to Open Source Collective","DEBIT","HOST_FEE","","","","-$10.00 USD",-10,0,-10,3452.62,"USD","hledger","hledger","opensource","Open Source Collective",,,,"",,,
"2021-09-01T15:16:37","1d3b7a39","30a1a8f0","Monthly contribution from Brandon Barker (Individuals)","CREDIT","CONTRIBUTION","","","","$2.00 USD",2,-0.36,1.64,3462.62,"USD","hledger","hledger","brandonbarker","Brandon Barker","STRIPE","CREDITCARD",,"",,,
"2021-09-01T15:16:37","07b5c7ea","30a1a8f0","Host Fee to Open Source Collective","DEBIT","HOST_FEE","","","","-$0.20 USD",-0.2,0,-0.2,3460.98,"USD","hledger","hledger","opensource","Open Source Collective",,,,"",,,
"2021-09-01T15:15:51","d1fd1161","294b8f06","Monthly contribution from Tony Xiao (Individuals)","CREDIT","CONTRIBUTION","","","","$10.00 USD",10,-0.59,9.41,3461.18,"USD","hledger","hledger","tony-xiao1","Tony Xiao","STRIPE","CREDITCARD",,"",,,
"2021-09-01T15:15:51","e0a7ee1c","294b8f06","Host Fee to Open Source Collective","DEBIT","HOST_FEE","","","","-$1.00 USD",-1,0,-1,3451.77,"USD","hledger","hledger","opensource","Open Source Collective",,,,"",,,
"2021-09-01T15:13:11","7383d28e","5a651099","Monthly contribution from Rishi Hyanki (Individuals)","CREDIT","CONTRIBUTION","","","","$2.00 USD",2,-0.36,1.64,3452.77,"USD","hledger","hledger","rhyanki","Rishi Hyanki","STRIPE","CREDITCARD",,"",,,
"2021-09-01T15:13:11","08d37b00","5a651099","Host Fee to Open Source Collective","DEBIT","HOST_FEE","","","","-$0.20 USD",-0.2,0,-0.2,3451.13,"USD","hledger","hledger","opensource","Open Source Collective",,,,"",,,
"2021-09-01T15:04:50","d0b92afa","78bc2318","Monthly contribution from Jack Todaro (Individuals)","CREDIT","CONTRIBUTION","","","","$2.00 USD",2,-0.38,1.62,3451.33,"USD","hledger","hledger","jack-todaro","Jack Todaro","STRIPE","CREDITCARD",,"",,,
"2021-09-01T15:04:50","7d2ac4ea","78bc2318","Host Fee to Open Source Collective","DEBIT","HOST_FEE","","","","-$0.20 USD",-0.2,0,-0.2,3449.71,"USD","hledger","hledger","opensource","Open Source Collective",,,,"",,,
"2021-09-01T05:16:02","aaa251b1","fd800116","Monthly contribution from Richard Kelly (Individuals)","CREDIT","CONTRIBUTION","","","","$2.00 USD",2,-0.36,1.64,3449.91,"USD","hledger","hledger","richard-kelly","Richard Kelly","STRIPE","CREDITCARD",,"",,,
"2021-09-01T05:16:02","79c5a7c7","fd800116","Host Fee to Open Source Collective","DEBIT","HOST_FEE","","","","-$0.20 USD",-0.2,0,-0.2,3448.27,"USD","hledger","hledger","opensource","Open Source Collective",,,,"",,,
"2021-09-01T05:08:15","70e64967","316c0801","Monthly contribution from MSATC (Individuals)","CREDIT","CONTRIBUTION","","","","$2.00 USD",2,-0.38,1.62,3448.47,"USD","hledger","hledger","msatc","MSATC","STRIPE","CREDITCARD",,"",,,
"2021-09-01T05:08:15","f46f4e7a","316c0801","Host Fee to Open Source Collective","DEBIT","HOST_FEE","","","","-$0.20 USD",-0.2,0,-0.2,3446.85,"USD","hledger","hledger","opensource","Open Source Collective",,,,"",,,
"2021-09-01T03:02:32","a77673fe","dad97e71","Monthly contribution from Gyula Weber (Individuals)","CREDIT","CONTRIBUTION","","","","$5.00 USD",5,-0.5,4.5,3447.05,"USD","hledger","hledger","gyula_weber","Gyula Weber","STRIPE","CREDITCARD",,"",,,
"2021-09-01T03:02:32","dd272da8","dad97e71","Host Fee to Open Source Collective","DEBIT","HOST_FEE","","","","-$0.50 USD",-0.5,0,-0.5,3442.55,"USD","hledger","hledger","opensource","Open Source Collective",,,,"",,,
"2021-09-01T01:06:01","d6aad227","dc0e01ce","Monthly contribution from Michael Martinides (Individuals)","CREDIT","CONTRIBUTION","","","","$2.00 USD",2,-0.38,1.62,3443.05,"USD","hledger","hledger","michael-martinides","Michael Martinides","STRIPE","CREDITCARD",,"",,,
"2021-09-01T01:06:01","3e6ec6a0","dc0e01ce","Host Fee to Open Source Collective","DEBIT","HOST_FEE","","","","-$0.20 USD",-0.2,0,-0.2,3441.43,"USD","hledger","hledger","opensource","Open Source Collective",,,,"",,,
"2021-09-01T01:04:55","41cab4d6","dbf98dce","Monthly contribution from October Swimmer (Organisations)","CREDIT","CONTRIBUTION","","","","$100.00 USD",100,-3.2,96.8,3441.63,"USD","hledger","hledger","october-swimmer","October Swimmer",,,,"",,,
"2021-09-01T01:04:55","3f5c489d","dbf98dce","Host Fee to Open Source Collective","DEBIT","HOST_FEE","","","","-$10.00 USD",-10,0,-10,3344.83,"USD","hledger","hledger","opensource","Open Source Collective",,,,"",,,
"2021-08-26T22:24:36","dc121057","8d140f93","Expense from Stephen Morgan - regression bounty","DEBIT","EXPENSE","","","","-$100.00 USD",-100,-0.84,-100.84,3354.83,"USD","hledger","hledger","stephen-morgan","Stephen Morgan",,,"INVOICE","","BANK_ACCOUNT",,
"2021-08-26T22:24:07","b8bc86e5","f59a6253","Expense from Stephen Morgan - Collecting bounty on #1412","DEBIT","EXPENSE","","","","-$10.00 USD",-10,-0.44,-10.44,3455.67,"USD","hledger","hledger","stephen-morgan","Stephen Morgan",,,"INVOICE","","BANK_ACCOUNT",,
"2021-08-23T08:33:19","b5de006b","18458059","Contribution from Yann Büchau","CREDIT","CONTRIBUTION","","","","$10.00 USD",10,-0.99,9.01,3466.11,"USD","hledger","hledger","yann-buechau","Yann Büchau","PAYPAL","PAYMENT",,"",,,
"2021-08-23T08:33:19","d49a0d19","18458059","Host Fee to Open Source Collective","DEBIT","HOST_FEE","","","","-$1.00 USD",-1,0,-1,3457.1,"USD","hledger","hledger","opensource","Open Source Collective",,,,"",,,
"2021-08-19T10:52:49","16950498","e9afaa3a","Monthly contribution from APM Help (Organisations)","CREDIT","CONTRIBUTION","","","","$100.00 USD",100,-3.98,96.02,3458.1,"USD","hledger","hledger","apmhelp","APM Help","PAYPAL","SUBSCRIPTION",,"",,,
"2021-08-19T10:52:49","19341b27","e9afaa3a","Host Fee to Open Source Collective","DEBIT","HOST_FEE","","","","-$10.00 USD",-10,0,-10,3362.08,"USD","hledger","hledger","opensource","Open Source Collective",,,,"",,,
"2021-08-14T20:17:23","f3226d24","42af33cc","Contribution from Michael Manganiello","CREDIT","CONTRIBUTION","","","","$5.00 USD",5,-0.74,4.26,3372.08,"USD","hledger","hledger","guest-c173624c","Michael Manganiello","PAYPAL","PAYMENT",,"",,,
"2021-08-14T20:17:23","abd76595","42af33cc","Host Fee to Open Source Collective","DEBIT","HOST_FEE","","","","-$0.50 USD",-0.5,0,-0.5,3367.82,"USD","hledger","hledger","opensource","Open Source Collective",,,,"",,,
"2021-08-06T03:06:17","835ee4ff","58c4bb8d","Expense from Yann Büchau - regression bounty","DEBIT","EXPENSE","","","","-$100.00 USD",-100,-2,-102,3368.32,"USD","hledger","hledger","yann-buechau","Yann Büchau",,,"INVOICE","bounty","PAYPAL",,
"2021-08-05T06:31:18","286a2206","9d8c0c88","Monthly contribution from Brandon J Wong (Individuals)","CREDIT","CONTRIBUTION","","","","$2.00 USD",2,-0.38,1.62,3470.32,"USD","hledger","hledger","brandon-j-wong","Brandon J Wong",,,,"",,,
"2021-08-05T06:31:18","29f0a126","9d8c0c88","Host Fee to Open Source Collective","DEBIT","HOST_FEE","","","","-$0.20 USD",-0.2,0,-0.2,3468.7,"USD","hledger","hledger","opensource","Open Source Collective",,,,"",,,
"2021-08-02T21:47:51","9130ab30","36f56b4c","Expense from Julian Andres Klode - regression bounty","DEBIT","EXPENSE","","","","-$100.01 USD",-100.01,-0.76,-100.77,3468.9,"USD","hledger","hledger","julian-andres-klode","Julian Andres Klode",,,"INVOICE","","BANK_ACCOUNT",,
"2021-08-01T23:11:42","d88c18dd","59f5879c","Monthly contribution from Writers Per Hour (Organisations)","CREDIT","CONTRIBUTION","","","","$100.00 USD",100,-4.2,95.8,3569.67,"USD","hledger","hledger","writersperhour","Writers Per Hour","STRIPE","CREDITCARD",,"",,,
"2021-08-01T23:11:42","47b6d072","59f5879c","Host Fee to Open Source Collective","DEBIT","HOST_FEE","","","","-$10.00 USD",-10,0,-10,3473.87,"USD","hledger","hledger","opensource","Open Source Collective",,,,"",,,
"2021-08-01T22:03:58","2ffc9271","84e75238","Monthly contribution from James Blachly (Individuals)","CREDIT","CONTRIBUTION","","","","$2.00 USD",2,-0.36,1.64,3483.87,"USD","hledger","hledger","james-blachly","James Blachly","STRIPE","CREDITCARD",,"",,,
"2021-08-01T22:03:58","66eaf7a9","84e75238","Host Fee to Open Source Collective","DEBIT","HOST_FEE","","","","-$0.20 USD",-0.2,0,-0.2,3482.23,"USD","hledger","hledger","opensource","Open Source Collective",,,,"",,,
"2021-08-01T20:10:57","5ebddaac","70a1af58","Monthly contribution from Paulo Makdisse (Individuals)","CREDIT","CONTRIBUTION","","","","$2.00 USD",2,-0.38,1.62,3482.43,"USD","hledger","hledger","paulo-makdisse","Paulo Makdisse","STRIPE","CREDITCARD",,"",,,
"2021-08-01T20:10:57","da1e9929","70a1af58","Host Fee to Open Source Collective","DEBIT","HOST_FEE","","","","-$0.20 USD",-0.2,0,-0.2,3480.81,"USD","hledger","hledger","opensource","Open Source Collective",,,,"",,,
"2021-08-01T18:10:29","de96bf9b","634f62dc","Monthly contribution from HLO_APC (Individuals)","CREDIT","CONTRIBUTION","","","","$2.00 USD",2,-0.36,1.64,3481.01,"USD","hledger","hledger","hlo_apc","HLO_APC","STRIPE","CREDITCARD",,"",,,
"2021-08-01T18:10:29","98cd1b21","634f62dc","Host Fee to Open Source Collective","DEBIT","HOST_FEE","","","","-$0.20 USD",-0.2,0,-0.2,3479.37,"USD","hledger","hledger","opensource","Open Source Collective",,,,"",,,
"2021-08-01T17:13:50","a68e5aad","f5318d30","Monthly contribution from FinMasters (Organisations)","CREDIT","CONTRIBUTION","","","","$100.00 USD",100,-4.2,95.8,3479.57,"USD","hledger","hledger","finmasters","FinMasters","STRIPE","CREDITCARD",,"",,,
"2021-08-01T17:13:50","1e3b3ee6","f5318d30","Host Fee to Open Source Collective","DEBIT","HOST_FEE","","","","-$10.00 USD",-10,0,-10,3383.77,"USD","hledger","hledger","opensource","Open Source Collective",,,,"",,,
"2021-08-01T16:15:39","3e6fe0ba","637426fc","Monthly contribution from Brandon Barker (Individuals)","CREDIT","CONTRIBUTION","","","","$2.00 USD",2,-0.36,1.64,3393.77,"USD","hledger","hledger","brandonbarker","Brandon Barker","STRIPE","CREDITCARD",,"",,,
"2021-08-01T16:15:39","d2a2db51","637426fc","Host Fee to Open Source Collective","DEBIT","HOST_FEE","","","","-$0.20 USD",-0.2,0,-0.2,3392.13,"USD","hledger","hledger","opensource","Open Source Collective",,,,"",,,
"2021-08-01T16:14:45","95676735","f559f149","Monthly contribution from Tony Xiao (Individuals)","CREDIT","CONTRIBUTION","","","","$10.00 USD",10,-0.59,9.41,3392.33,"USD","hledger","hledger","tony-xiao1","Tony Xiao","STRIPE","CREDITCARD",,"",,,
"2021-08-01T16:14:45","4529efe0","f559f149","Host Fee to Open Source Collective","DEBIT","HOST_FEE","","","","-$1.00 USD",-1,0,-1,3382.92,"USD","hledger","hledger","opensource","Open Source Collective",,,,"",,,
"2021-08-01T16:12:10","e88bdbd1","89e7b803","Monthly contribution from Rishi Hyanki (Individuals)","CREDIT","CONTRIBUTION","","","","$2.00 USD",2,-0.36,1.64,3383.92,"USD","hledger","hledger","rhyanki","Rishi Hyanki","STRIPE","CREDITCARD",,"",,,
"2021-08-01T16:12:10","92541a4f","89e7b803","Host Fee to Open Source Collective","DEBIT","HOST_FEE","","","","-$0.20 USD",-0.2,0,-0.2,3382.28,"USD","hledger","hledger","opensource","Open Source Collective",,,,"",,,
"2021-08-01T15:17:56","fb392a0f","eacebc09","Monthly contribution from Jack Todaro (Individuals)","CREDIT","CONTRIBUTION","","","","$2.00 USD",2,-0.38,1.62,3382.48,"USD","hledger","hledger","jack-todaro","Jack Todaro","STRIPE","CREDITCARD",,"",,,
"2021-08-01T15:17:56","199ab737","eacebc09","Host Fee to Open Source Collective","DEBIT","HOST_FEE","","","","-$0.20 USD",-0.2,0,-0.2,3380.86,"USD","hledger","hledger","opensource","Open Source Collective",,,,"",,,
"2021-08-01T06:07:58","9a4203dc","96cd6e75","Monthly contribution from Richard Kelly (Individuals)","CREDIT","CONTRIBUTION","","","","$2.00 USD",2,-0.36,1.64,3381.06,"USD","hledger","hledger","richard-kelly","Richard Kelly","STRIPE","CREDITCARD",,"",,,
"2021-08-01T06:07:58","4476a01e","96cd6e75","Host Fee to Open Source Collective","DEBIT","HOST_FEE","","","","-$0.20 USD",-0.2,0,-0.2,3379.42,"USD","hledger","hledger","opensource","Open Source Collective",,,,"",,,
"2021-08-01T05:11:37","12f2e8e3","0caebdc4","Monthly contribution from MSATC (Individuals)","CREDIT","CONTRIBUTION","","","","$2.00 USD",2,-0.38,1.62,3379.62,"USD","hledger","hledger","msatc","MSATC","STRIPE","CREDITCARD",,"",,,
"2021-08-01T05:11:37","84ad2db4","0caebdc4","Host Fee to Open Source Collective","DEBIT","HOST_FEE","","","","-$0.20 USD",-0.2,0,-0.2,3378,"USD","hledger","hledger","opensource","Open Source Collective",,,,"",,,
"2021-08-01T03:03:59","731d0369","46acd97f","Monthly contribution from Gyula Weber (Individuals)","CREDIT","CONTRIBUTION","","","","$5.00 USD",5,-0.5,4.5,3378.2,"USD","hledger","hledger","gyula_weber","Gyula Weber","STRIPE","CREDITCARD",,"",,,
"2021-08-01T03:03:59","efde471a","46acd97f","Host Fee to Open Source Collective","DEBIT","HOST_FEE","","","","-$0.50 USD",-0.5,0,-0.5,3373.7,"USD","hledger","hledger","opensource","Open Source Collective",,,,"",,,
"2021-08-01T01:10:34","3e95de84","20e753c8","Monthly contribution from Michael Martinides (Individuals)","CREDIT","CONTRIBUTION","","","","$2.00 USD",2,-0.38,1.62,3374.2,"USD","hledger","hledger","michael-martinides","Michael Martinides","STRIPE","CREDITCARD",,"",,,
"2021-08-01T01:10:34","04a2555e","20e753c8","Host Fee to Open Source Collective","DEBIT","HOST_FEE","","","","-$0.20 USD",-0.2,0,-0.2,3372.58,"USD","hledger","hledger","opensource","Open Source Collective",,,,"",,,
"2021-08-01T01:08:45","40c1e7ad","111c9a8f","Monthly contribution from October Swimmer (Organisations)","CREDIT","CONTRIBUTION","","","","$100.00 USD",100,-3.2,96.8,3372.78,"USD","hledger","hledger","october-swimmer","October Swimmer",,,,"",,,
"2021-08-01T01:08:45","2aa3dd2a","111c9a8f","Host Fee to Open Source Collective","DEBIT","HOST_FEE","","","","-$10.00 USD",-10,0,-10,3275.98,"USD","hledger","hledger","opensource","Open Source Collective",,,,"",,,
"2021-07-19T16:05:39","242ae183","eb8c86e6","Expense from Simon Michael - regression bounty","DEBIT","EXPENSE","","","","-$100.00 USD",-100,-0.25,-100.25,3285.98,"USD","hledger","hledger","simon","Simon Michael",,,"INVOICE","","PAYPAL",,
"2021-07-19T13:46:44","14b6e0ac","f4534172","Monthly contribution from APM Help (Organisations)","CREDIT","CONTRIBUTION","","","","$100.00 USD",100,-3.2,96.8,3386.23,"USD","hledger","hledger","apmhelp","APM Help","PAYPAL","SUBSCRIPTION",,"",,,
"2021-07-19T13:46:44","fed2ac9d","f4534172","Host Fee to Open Source Collective","DEBIT","HOST_FEE","","","","-$10.00 USD",-10,0,-10,3289.43,"USD","hledger","hledger","opensource","Open Source Collective",,,,"",,,
"2021-07-14T00:07:24","60a5a450","4c3854d4","Expense from Simon Michael - claiming regression bounty for #1597 (first expense / test)","DEBIT","EXPENSE","","","","-$50.00 USD",-50,-0.25,-50.25,3299.43,"USD","hledger","hledger","simon","Simon Michael",,,"INVOICE","bounty","PAYPAL",,
"2021-07-06T00:06:45","5d741065","7a4fd62b","Monthly contribution from Paulo Makdisse (Individuals)","CREDIT","CONTRIBUTION","","","","$2.00 USD",2,-0.38,1.62,3349.68,"USD","hledger","hledger","paulo-makdisse","Paulo Makdisse","STRIPE","CREDITCARD",,"",,,
"2021-07-06T00:06:45","6b4e5bd6","7a4fd62b","Host Fee to Open Source Collective","DEBIT","HOST_FEE","","","","-$0.20 USD",-0.2,0,-0.2,3348.06,"USD","hledger","hledger","opensource","Open Source Collective",,,,"",,,
"2021-07-02T08:19:10","5bd42b35","5ad2b8ba","Monthly contribution from Writers Per Hour (Organisations)","CREDIT","CONTRIBUTION","","","","$100.00 USD",100,-4.2,95.8,3348.26,"USD","hledger","hledger","writersperhour","Writers Per Hour","STRIPE","CREDITCARD",,"",,,
"2021-07-02T08:19:10","e4ac8979","5ad2b8ba","Host Fee to Open Source Collective","DEBIT","HOST_FEE","","","","-$10.00 USD",-10,0,-10,3252.46,"USD","hledger","hledger","opensource","Open Source Collective",,,,"",,,
"2021-07-02T07:25:02","bcaf6143","5780056c","Monthly contribution from James Blachly (Individuals)","CREDIT","CONTRIBUTION","","","","$2.00 USD",2,-0.36,1.64,3262.46,"USD","hledger","hledger","james-blachly","James Blachly","STRIPE","CREDITCARD",,"",,,
"2021-07-02T07:25:01","78ec8c9b","5780056c","Host Fee to Open Source Collective","DEBIT","HOST_FEE","","","","-$0.20 USD",-0.2,0,-0.2,3260.82,"USD","hledger","hledger","opensource","Open Source Collective",,,,"",,,
"2021-07-02T03:14:18","664726a9","9ba2db13","Monthly contribution from HLO_APC (Individuals)","CREDIT","CONTRIBUTION","","","","$2.00 USD",2,-0.36,1.64,3261.02,"USD","hledger","hledger","hlo_apc","HLO_APC","STRIPE","CREDITCARD",,"",,,
"2021-07-02T03:14:18","444f0f39","9ba2db13","Host Fee to Open Source Collective","DEBIT","HOST_FEE","","","","-$0.20 USD",-0.2,0,-0.2,3259.38,"USD","hledger","hledger","opensource","Open Source Collective",,,,"",,,
"2021-07-02T02:12:49","ef381a13","a3c07216","Monthly contribution from FinMasters (Organisations)","CREDIT","CONTRIBUTION","","","","$100.00 USD",100,-4.2,95.8,3259.58,"USD","hledger","hledger","finmasters","FinMasters","STRIPE","CREDITCARD",,"",,,
"2021-07-02T02:12:49","d80821bc","a3c07216","Host Fee to Open Source Collective","DEBIT","HOST_FEE","","","","-$10.00 USD",-10,0,-10,3163.78,"USD","hledger","hledger","opensource","Open Source Collective",,,,"",,,
"2021-07-02T01:16:46","526520c1","930de735","Monthly contribution from Brandon Barker (Individuals)","CREDIT","CONTRIBUTION","","","","$2.00 USD",2,-0.36,1.64,3173.78,"USD","hledger","hledger","brandonbarker","Brandon Barker","STRIPE","CREDITCARD",,"",,,
"2021-07-02T01:16:45","a29b80eb","930de735","Host Fee to Open Source Collective","DEBIT","HOST_FEE","","","","-$0.20 USD",-0.2,0,-0.2,3172.14,"USD","hledger","hledger","opensource","Open Source Collective",,,,"",,,
"2021-07-02T01:15:37","4e6bc1a1","74b77e55","Monthly contribution from Tony Xiao (Individuals)","CREDIT","CONTRIBUTION","","","","$10.00 USD",10,-0.59,9.41,3172.34,"USD","hledger","hledger","tony-xiao1","Tony Xiao","STRIPE","CREDITCARD",,"",,,
"2021-07-02T01:15:36","d69999cb","74b77e55","Host Fee to Open Source Collective","DEBIT","HOST_FEE","","","","-$1.00 USD",-1,0,-1,3162.93,"USD","hledger","hledger","opensource","Open Source Collective",,,,"",,,
"2021-07-02T01:12:37","7079ad1f","105daeb9","Monthly contribution from Rishi Hyanki (Individuals)","CREDIT","CONTRIBUTION","","","","$2.00 USD",2,-0.36,1.64,3163.93,"USD","hledger","hledger","rhyanki","Rishi Hyanki","STRIPE","CREDITCARD",,"",,,
"2021-07-02T01:12:37","2e38d4f2","105daeb9","Host Fee to Open Source Collective","DEBIT","HOST_FEE","","","","-$0.20 USD",-0.2,0,-0.2,3162.29,"USD","hledger","hledger","opensource","Open Source Collective",,,,"",,,
"2021-07-02T01:03:46","3ce0fd59","2f5f105b","Monthly contribution from Jack Todaro (Individuals)","CREDIT","CONTRIBUTION","","","","$2.00 USD",2,-0.38,1.62,3162.49,"USD","hledger","hledger","jack-todaro","Jack Todaro","STRIPE","CREDITCARD",,"",,,
"2021-07-02T01:03:45","b03297df","2f5f105b","Host Fee to Open Source Collective","DEBIT","HOST_FEE","","","","-$0.20 USD",-0.2,0,-0.2,3160.87,"USD","hledger","hledger","opensource","Open Source Collective",,,,"",,,
"2021-07-01T13:11:52","4b320fe8","274aa94b","Monthly contribution from Richard Kelly (Individuals)","CREDIT","CONTRIBUTION","","","","$2.00 USD",2,-0.36,1.64,3161.07,"USD","hledger","hledger","richard-kelly","Richard Kelly","STRIPE","CREDITCARD",,"",,,
"2021-07-01T13:11:52","a89f27eb","274aa94b","Host Fee to Open Source Collective","DEBIT","HOST_FEE","","","","-$0.20 USD",-0.2,0,-0.2,3159.43,"USD","hledger","hledger","opensource","Open Source Collective",,,,"",,,
"2021-07-01T12:13:13","d0de4200","73bf53ae","Monthly contribution from MSATC (Individuals)","CREDIT","CONTRIBUTION","","","","$2.00 USD",2,-0.38,1.62,3159.63,"USD","hledger","hledger","msatc","MSATC","STRIPE","CREDITCARD",,"",,,
"2021-07-01T12:13:13","66bd32f3","73bf53ae","Host Fee to Open Source Collective","DEBIT","HOST_FEE","","","","-$0.20 USD",-0.2,0,-0.2,3158.01,"USD","hledger","hledger","opensource","Open Source Collective",,,,"",,,
"2021-07-01T10:05:35","ce547f2e","1fb80f5c","Monthly contribution from Gyula Weber (Individuals)","CREDIT","CONTRIBUTION","","","","$5.00 USD",5,-0.5,4.5,3158.21,"USD","hledger","hledger","gyula_weber","Gyula Weber","STRIPE","CREDITCARD",,"",,,
"2021-07-01T10:05:35","158fcfe6","1fb80f5c","Host Fee to Open Source Collective","DEBIT","HOST_FEE","","","","-$0.50 USD",-0.5,0,-0.5,3153.71,"USD","hledger","hledger","opensource","Open Source Collective",,,,"",,,
"2021-07-01T08:38:56","e85c63a6","c32f567b","Monthly contribution from Michael Martinides (Individuals)","CREDIT","CONTRIBUTION","","","","$2.00 USD",2,-0.38,1.62,3154.21,"USD","hledger","hledger","michael-martinides","Michael Martinides","STRIPE","CREDITCARD",,"",,,
"2021-07-01T08:38:56","51822cd8","c32f567b","Host Fee to Open Source Collective","DEBIT","HOST_FEE","","","","-$0.20 USD",-0.2,0,-0.2,3152.59,"USD","hledger","hledger","opensource","Open Source Collective",,,,"",,,
"2021-07-01T08:37:31","0a7d3631","b833fded","Monthly contribution from October Swimmer (Organisations)","CREDIT","CONTRIBUTION","","","","$100.00 USD",100,-3.2,96.8,3152.79,"USD","hledger","hledger","october-swimmer","October Swimmer",,,,"",,,
"2021-07-01T08:37:31","c44ce71c","b833fded","Host Fee to Open Source Collective","DEBIT","HOST_FEE","","","","-$10.00 USD",-10,0,-10,3055.99,"USD","hledger","hledger","opensource","Open Source Collective",,,,"",,,
"2021-06-19T11:12:56","969a6061","547f2db2","Host Fee to Open Source Collective","DEBIT","HOST_FEE","","","","-$10.00 USD",-10,0,-10,3065.99,"USD","hledger","hledger","opensource","Open Source Collective",,,,"",,,
"2021-06-19T11:12:56","bd952fea","547f2db2","Monthly contribution from APM Help (Organisations)","CREDIT","CONTRIBUTION","","","","$100.00 USD",100,-3.2,96.8,3075.99,"USD","hledger","hledger","apmhelp","APM Help","PAYPAL","SUBSCRIPTION",,"",,,
"2021-06-02T04:05:37","367b4a7b","c96c6ce5","Host Fee to Open Source Collective","DEBIT","HOST_FEE","","","","-$10.00 USD",-10,0,-10,2979.19,"USD","hledger","hledger","opensource","Open Source Collective",,,,"",,,
"2021-06-02T04:05:37","dde354cb","c96c6ce5","Monthly contribution from Writers Per Hour (Organisations)","CREDIT","CONTRIBUTION","","","","$100.00 USD",100,-4.2,95.8,2989.19,"USD","hledger","hledger","writersperhour","Writers Per Hour","STRIPE","CREDITCARD",,"",,,
"2021-06-02T02:11:32","2415a9fe","85707a10","Host Fee to Open Source Collective","DEBIT","HOST_FEE","","","","-$0.20 USD",-0.2,0,-0.2,2893.39,"USD","hledger","hledger","opensource","Open Source Collective",,,,"",,,
"2021-06-02T02:11:32","b9c856e3","85707a10","Monthly contribution from James Blachly (Individuals)","CREDIT","CONTRIBUTION","","","","$2.00 USD",2,-0.36,1.64,2893.59,"USD","hledger","hledger","james-blachly","James Blachly","STRIPE","CREDITCARD",,"",,,
"2021-06-02T00:14:18","9f702526","551d9e1c","Host Fee to Open Source Collective","DEBIT","HOST_FEE","","","","-$0.20 USD",-0.2,0,-0.2,2891.95,"USD","hledger","hledger","opensource","Open Source Collective",,,,"",,,
"2021-06-02T00:14:18","40c330d7","551d9e1c","Monthly contribution from Paulo Makdisse (Individuals)","CREDIT","CONTRIBUTION","","","","$2.00 USD",2,-0.38,1.62,2892.15,"USD","hledger","hledger","paulo-makdisse","Paulo Makdisse","STRIPE","CREDITCARD",,"",,,
"2021-06-01T22:08:39","7a7e15d5","8464e7e7","Host Fee to Open Source Collective","DEBIT","HOST_FEE","","","","-$0.20 USD",-0.2,0,-0.2,2890.53,"USD","hledger","hledger","opensource","Open Source Collective",,,,"",,,
"2021-06-01T22:08:39","8c736b30","8464e7e7","Monthly contribution from HLO_APC (Individuals)","CREDIT","CONTRIBUTION","","","","$2.00 USD",2,-0.36,1.64,2890.73,"USD","hledger","hledger","hlo_apc","HLO_APC","STRIPE","CREDITCARD",,"",,,
"2021-06-01T21:10:19","9fe74364","051546e3","Host Fee to Open Source Collective","DEBIT","HOST_FEE","","","","-$10.00 USD",-10,0,-10,2889.09,"USD","hledger","hledger","opensource","Open Source Collective",,,,"",,,
"2021-06-01T21:10:19","723b7a58","051546e3","Monthly contribution from FinMasters (Organisations)","CREDIT","CONTRIBUTION","","","","$100.00 USD",100,-4.2,95.8,2899.09,"USD","hledger","hledger","finmasters","FinMasters","STRIPE","CREDITCARD",,"",,,
"2021-06-01T20:07:56","52a6910c","3d5e7b12","Host Fee to Open Source Collective","DEBIT","HOST_FEE","","","","-$0.20 USD",-0.2,0,-0.2,2803.29,"USD","hledger","hledger","opensource","Open Source Collective",,,,"",,,
"2021-06-01T20:07:56","4bec87ad","3d5e7b12","Monthly contribution from Brandon Barker (Individuals)","CREDIT","CONTRIBUTION","","","","$2.00 USD",2,-0.36,1.64,2803.49,"USD","hledger","hledger","brandonbarker","Brandon Barker","STRIPE","CREDITCARD",,"",,,
"2021-06-01T20:06:56","13060203","2dcdbd08","Host Fee to Open Source Collective","DEBIT","HOST_FEE","","","","-$1.00 USD",-1,0,-1,2801.85,"USD","hledger","hledger","opensource","Open Source Collective",,,,"",,,
"2021-06-01T20:06:56","b827d4e6","2dcdbd08","Monthly contribution from Tony Xiao (Individuals)","CREDIT","CONTRIBUTION","","","","$10.00 USD",10,-0.59,9.41,2802.85,"USD","hledger","hledger","tony-xiao1","Tony Xiao","STRIPE","CREDITCARD",,"",,,
"2021-06-01T20:04:16","2f37c787","862ccc34","Host Fee to Open Source Collective","DEBIT","HOST_FEE","","","","-$0.20 USD",-0.2,0,-0.2,2793.44,"USD","hledger","hledger","opensource","Open Source Collective",,,,"",,,
"2021-06-01T20:04:16","351d94c1","862ccc34","Monthly contribution from Rishi Hyanki (Individuals)","CREDIT","CONTRIBUTION","","","","$2.00 USD",2,-0.36,1.64,2793.64,"USD","hledger","hledger","rhyanki","Rishi Hyanki","STRIPE","CREDITCARD",,"",,,
"2021-06-01T19:08:09","f460a29b","9d92f9b3","Host Fee to Open Source Collective","DEBIT","HOST_FEE","","","","-$0.20 USD",-0.2,0,-0.2,2792,"USD","hledger","hledger","opensource","Open Source Collective",,,,"",,,
"2021-06-01T19:08:09","cfddb8b5","9d92f9b3","Monthly contribution from Jack Todaro (Individuals)","CREDIT","CONTRIBUTION","","","","$2.00 USD",2,-0.38,1.62,2792.2,"USD","hledger","hledger","jack-todaro","Jack Todaro","STRIPE","CREDITCARD",,"",,,
"2021-06-01T08:08:02","b2a94f84","504b03e5","Host Fee to Open Source Collective","DEBIT","HOST_FEE","","","","-$0.20 USD",-0.2,0,-0.2,2790.58,"USD","hledger","hledger","opensource","Open Source Collective",,,,"",,,
"2021-06-01T08:08:02","b2399c46","504b03e5","Monthly contribution from Richard Kelly (Individuals)","CREDIT","CONTRIBUTION","","","","$2.00 USD",2,-0.36,1.64,2790.78,"USD","hledger","hledger","richard-kelly","Richard Kelly","STRIPE","CREDITCARD",,"",,,
"2021-06-01T07:09:15","104a16db","1c962095","Host Fee to Open Source Collective","DEBIT","HOST_FEE","","","","-$0.20 USD",-0.2,0,-0.2,2789.14,"USD","hledger","hledger","opensource","Open Source Collective",,,,"",,,
"2021-06-01T07:09:15","e7090aae","1c962095","Monthly contribution from MSATC (Individuals)","CREDIT","CONTRIBUTION","","","","$2.00 USD",2,-0.38,1.62,2789.34,"USD","hledger","hledger","msatc","MSATC","STRIPE","CREDITCARD",,"",,,
"2021-06-01T04:11:46","46cc0d2f","88e1b86f","Host Fee to Open Source Collective","DEBIT","HOST_FEE","","","","-$0.50 USD",-0.5,0,-0.5,2787.72,"USD","hledger","hledger","opensource","Open Source Collective",,,,"",,,
"2021-06-01T04:11:46","a790dc44","88e1b86f","Monthly contribution from Gyula Weber (Individuals)","CREDIT","CONTRIBUTION","","","","$5.00 USD",5,-0.5,4.5,2788.22,"USD","hledger","hledger","gyula_weber","Gyula Weber","STRIPE","CREDITCARD",,"",,,
"2021-06-01T02:10:10","a476761b","e1db93c4","Host Fee to Open Source Collective","DEBIT","HOST_FEE","","","","-$0.20 USD",-0.2,0,-0.2,2783.72,"USD","hledger","hledger","opensource","Open Source Collective",,,,"",,,
"2021-06-01T02:10:10","09982b44","e1db93c4","Monthly contribution from Michael Martinides (Individuals)","CREDIT","CONTRIBUTION","","","","$2.00 USD",2,-0.38,1.62,2783.92,"USD","hledger","hledger","michael-martinides","Michael Martinides","STRIPE","CREDITCARD",,"",,,
"2021-06-01T02:08:37","95a61220","6b474b38","Host Fee to Open Source Collective","DEBIT","HOST_FEE","","","","-$10.00 USD",-10,0,-10,2782.3,"USD","hledger","hledger","opensource","Open Source Collective",,,,"",,,
"2021-06-01T02:08:37","65365e36","6b474b38","Monthly contribution from October Swimmer (Organisations)","CREDIT","CONTRIBUTION","","","","$100.00 USD",100,-3.2,96.8,2792.3,"USD","hledger","hledger","october-swimmer","October Swimmer",,,,"",,,
"2021-05-20T03:05:47","b9c6aa71","f4876a1c","Monthly contribution from APM Help (Organisations)","CREDIT","CONTRIBUTION","","","","$100.00 USD",100,-3.2,86.8,2695.5,"USD","hledger","hledger","apmhelp","APM Help","PAYPAL","SUBSCRIPTION",,"",,,
"2021-05-03T00:13:15","65371663","c95d90c8","Monthly contribution from Writers Per Hour (Organisations)","CREDIT","CONTRIBUTION","","","","$100.00 USD",100,-4.2,85.8,2608.7,"USD","hledger","hledger","writersperhour","Writers Per Hour","STRIPE","CREDITCARD",,"",,,
"2021-05-02T00:17:13","f3ba40d3","286ce274","Monthly contribution from Paulo Makdisse (Individuals)","CREDIT","CONTRIBUTION","","","","$2.00 USD",2,-0.38,1.42,2522.9,"USD","hledger","hledger","paulo-makdisse","Paulo Makdisse","STRIPE","CREDITCARD",,"",,,
"2021-05-01T22:09:44","63ccf441","e45ad494","Monthly contribution from HLO_APC (Individuals)","CREDIT","CONTRIBUTION","","","","$2.00 USD",2,-0.36,1.44,2521.48,"USD","hledger","hledger","hlo_apc","HLO_APC","STRIPE","CREDITCARD",,"",,,
"2021-05-01T21:07:58","9310c0bd","f43effc5","Monthly contribution from FinMasters (Organisations)","CREDIT","CONTRIBUTION","","","","$100.00 USD",100,-4.2,85.8,2520.04,"USD","hledger","hledger","finmasters","FinMasters","STRIPE","CREDITCARD",,"",,,
"2021-05-01T20:07:54","568ef47b","0e6430f1","Monthly contribution from Brandon Barker (Individuals)","CREDIT","CONTRIBUTION","","","","$2.00 USD",2,-0.36,1.44,2434.24,"USD","hledger","hledger","brandonbarker","Brandon Barker","STRIPE","CREDITCARD",,"",,,
"2021-05-01T20:06:39","4b911cad","9a59172a","Monthly contribution from Tony Xiao (Individuals)","CREDIT","CONTRIBUTION","","","","$10.00 USD",10,-0.59,8.41,2432.8,"USD","hledger","hledger","tony-xiao1","Tony Xiao","STRIPE","CREDITCARD",,"",,,
"2021-05-01T20:03:45","ec92888a","126e26bd","Monthly contribution from Rishi Hyanki (Individuals)","CREDIT","CONTRIBUTION","","","","$2.00 USD",2,-0.36,1.44,2424.39,"USD","hledger","hledger","rhyanki","Rishi Hyanki","STRIPE","CREDITCARD",,"",,,
"2021-05-01T19:09:29","e891fed8","8ccba4b2","Monthly contribution from Jack Todaro (Individuals)","CREDIT","CONTRIBUTION","","","","$2.00 USD",2,-0.38,1.42,2422.95,"USD","hledger","hledger","jack-todaro","Jack Todaro","STRIPE","CREDITCARD",,"",,,
"2021-05-01T07:14:23","c27a5d02","f34e39ea","Monthly contribution from Richard Kelly (Individuals)","CREDIT","CONTRIBUTION","","","","$2.00 USD",2,-0.36,1.44,2421.53,"USD","hledger","hledger","richard-kelly","Richard Kelly","STRIPE","CREDITCARD",,"",,,
"2021-05-01T06:16:37","44d91a8e","1abb6981","Monthly contribution from MSATC (Individuals)","CREDIT","CONTRIBUTION","","","","$2.00 USD",2,-0.38,1.42,2420.09,"USD","hledger","hledger","msatc","MSATC","STRIPE","CREDITCARD",,"",,,
"2021-05-01T03:12:40","4a8b9485","7f9d5e25","Monthly contribution from Gyula Weber (Individuals)","CREDIT","CONTRIBUTION","","","","$5.00 USD",5,-0.5,4,2418.67,"USD","hledger","hledger","gyula_weber","Gyula Weber","STRIPE","CREDITCARD",,"",,,
"2021-05-01T01:16:17","23a2ff26","c3f42e7b","Monthly contribution from Michael Martinides (Individuals)","CREDIT","CONTRIBUTION","","","","$2.00 USD",2,-0.38,1.42,2414.67,"USD","hledger","hledger","michael-martinides","Michael Martinides","STRIPE","CREDITCARD",,"",,,
"2021-05-01T01:13:51","46974380","8aa606bd","Monthly contribution from October Swimmer (Organisations)","CREDIT","CONTRIBUTION","","","","$100.00 USD",100,-3.2,86.8,2413.25,"USD","hledger","hledger","october-swimmer","October Swimmer",,,,"",,,
"2021-04-20T19:24:48","cee6911d","ace1a042","Monthly contribution from James Blachly (Individuals)","CREDIT","CONTRIBUTION","","","","$2.00 USD",2,-0.36,1.44,2326.45,"USD","hledger","hledger","james-blachly","James Blachly","STRIPE","CREDITCARD",,"",,,
"2021-04-03T00:11:19","acc49123","2acc540e","Monthly contribution from Writers Per Hour (Organisations)","CREDIT","CONTRIBUTION","","","","$100.00 USD",100,-4.2,85.8,2325.01,"USD","hledger","hledger","writersperhour","Writers Per Hour","STRIPE","CREDITCARD",,"",,,
"2021-04-02T00:11:02","d45818b7","1b663e64","Monthly contribution from Paulo Makdisse (Individuals)","CREDIT","CONTRIBUTION","","","","$2.00 USD",2,-0.38,1.42,2239.21,"USD","hledger","hledger","paulo-makdisse","Paulo Makdisse","STRIPE","CREDITCARD",,"",,,
"2021-04-01T21:19:43","1d47f33b","ff5815f2","Monthly contribution from HLO_APC (Individuals)","CREDIT","CONTRIBUTION","","","","$2.00 USD",2,-0.36,1.44,2237.79,"USD","hledger","hledger","hlo_apc","HLO_APC","STRIPE","CREDITCARD",,"",,,
"2021-04-01T20:19:25","c0e93168","36149478","Monthly contribution from Brandon Barker (Individuals)","CREDIT","CONTRIBUTION","","","","$2.00 USD",2,-0.36,1.44,2236.35,"USD","hledger","hledger","brandonbarker","Brandon Barker","STRIPE","CREDITCARD",,"",,,
"2021-04-01T20:17:53","73d903cd","c1605666","Monthly contribution from Tony Xiao (Individuals)","CREDIT","CONTRIBUTION","","","","$10.00 USD",10,-0.59,8.41,2234.91,"USD","hledger","hledger","tony-xiao1","Tony Xiao","STRIPE","CREDITCARD",,"",,,
"2021-04-01T20:14:40","e238c60c","47cbb290","Monthly contribution from Rishi Hyanki (Individuals)","CREDIT","CONTRIBUTION","","","","$2.00 USD",2,-0.36,1.44,2226.5,"USD","hledger","hledger","rhyanki","Rishi Hyanki","STRIPE","CREDITCARD",,"",,,
"2021-04-01T19:18:09","1d52be60","f2684a77","Monthly contribution from Jack Todaro (Individuals)","CREDIT","CONTRIBUTION","","","","$2.00 USD",2,-0.38,1.42,2225.06,"USD","hledger","hledger","jack-todaro","Jack Todaro","STRIPE","CREDITCARD",,"",,,
"2021-04-01T16:15:59","233c94a2","1c3eb821","Monthly contribution from Anselm Peischl (Individuals)","CREDIT","CONTRIBUTION","","","","$5.00 USD",5,-0.5,4,2223.64,"USD","hledger","hledger","anselm-peischl","Anselm Peischl","STRIPE","CREDITCARD",,"",,,
"2021-04-01T07:20:34","21d22dd7","07879eb9","Monthly contribution from Richard Kelly (Individuals)","CREDIT","CONTRIBUTION","","","","$2.00 USD",2,-0.36,1.44,2219.64,"USD","hledger","hledger","richard-kelly","Richard Kelly","STRIPE","CREDITCARD",,"",,,
"2021-04-01T07:06:53","539dfa44","cbb0c526","Monthly contribution from MSATC (Individuals)","CREDIT","CONTRIBUTION","","","","$2.00 USD",2,-0.38,1.42,2218.2,"USD","hledger","hledger","msatc","MSATC","STRIPE","CREDITCARD",,"",,,
"2021-04-01T04:01:52","21d54081","2c4bb397","Monthly contribution from Gyula Weber (Individuals)","CREDIT","CONTRIBUTION","","","","$5.00 USD",5,-0.5,4,2216.78,"USD","hledger","hledger","gyula_weber","Gyula Weber","STRIPE","CREDITCARD",,"",,,
"2021-04-01T01:22:54","9cca1033","ed39ec6b","Monthly contribution from Michael Martinides (Individuals)","CREDIT","CONTRIBUTION","","","","$2.00 USD",2,-0.38,1.42,2212.78,"USD","hledger","hledger","michael-martinides","Michael Martinides","STRIPE","CREDITCARD",,"",,,
"2021-04-01T01:20:52","23972a12","a64ceb2b","Monthly contribution from October Swimmer (Organisations)","CREDIT","CONTRIBUTION","","","","$100.00 USD",100,-3.2,86.8,2211.36,"USD","hledger","hledger","october-swimmer","October Swimmer",,,,"",,,
"2021-03-24T11:39:05","e99cf5d0","1befb390","Monthly contribution from FinMasters (Organisations)","CREDIT","CONTRIBUTION","","","","$100.00 USD",100,-4.2,85.8,2124.56,"USD","hledger","hledger","finmasters","FinMasters","STRIPE","CREDITCARD",,"",,,
"2021-03-01T23:12:52","bad8dcbb","48804f06","Monthly contribution from Brandon Barker (Individuals)","CREDIT","CONTRIBUTION","","","","$2.00 USD",2,-0.36,1.44,2038.76,"USD","hledger","hledger","brandonbarker","Brandon Barker","STRIPE","CREDITCARD",,"",,,
"2021-03-01T23:11:43","3677d581","51732b9a","Monthly contribution from Tony Xiao (Individuals)","CREDIT","CONTRIBUTION","","","","$10.00 USD",10,-0.59,8.41,2037.32,"USD","hledger","hledger","tony-xiao1","Tony Xiao","STRIPE","CREDITCARD",,"",,,
"2021-03-01T23:08:58","e7c06099","4f1b2bc8","Monthly contribution from Rishi Hyanki (Individuals)","CREDIT","CONTRIBUTION","","","","$2.00 USD",2,-0.36,1.44,2028.91,"USD","hledger","hledger","rhyanki","Rishi Hyanki","STRIPE","CREDITCARD",,"",,,
"2021-03-01T22:12:28","8743dfa4","5c4d6269","Monthly contribution from Jack Todaro (Individuals)","CREDIT","CONTRIBUTION","","","","$2.00 USD",2,-0.38,1.42,2027.47,"USD","hledger","hledger","jack-todaro","Jack Todaro","STRIPE","CREDITCARD",,"",,,
"2021-03-01T20:07:44","a707360f","66521df9","Monthly contribution from HLO_APC (Individuals)","CREDIT","CONTRIBUTION","","","","$2.00 USD",2,-0.36,1.44,2026.05,"USD","hledger","hledger","hlo_apc","HLO_APC","STRIPE","CREDITCARD",,"",,,
"2021-03-01T19:17:03","457f3b9b","862555ef","Monthly contribution from Writers Per Hour (Organisations)","CREDIT","CONTRIBUTION","","","","$100.00 USD",100,-4.2,85.8,2024.61,"USD","hledger","hledger","writersperhour","Writers Per Hour","STRIPE","CREDITCARD",,"",,,
"2021-03-01T13:03:49","fffd9f73","a9943ea4","Monthly contribution from Paulo Makdisse (Individuals)","CREDIT","CONTRIBUTION","","","","$2.00 USD",2,-0.38,1.42,1938.81,"USD","hledger","hledger","paulo-makdisse","Paulo Makdisse","STRIPE","CREDITCARD",,"",,,
"2021-03-01T10:05:59","8ca728be","8d618ba2","Monthly contribution from Richard Kelly (Individuals)","CREDIT","CONTRIBUTION","","","","$2.00 USD",2,-0.36,1.44,1937.39,"USD","hledger","hledger","richard-kelly","Richard Kelly","STRIPE","CREDITCARD",,"",,,
"2021-03-01T09:04:40","075bedac","fd43c2a8","Monthly contribution from MSATC (Individuals)","CREDIT","CONTRIBUTION","","","","$2.00 USD",2,-0.38,1.42,1935.95,"USD","hledger","hledger","msatc","MSATC","STRIPE","CREDITCARD",,"",,,
"2021-03-01T05:06:55","69d6daf7","c5267cff","Monthly contribution from Gyula Weber (Individuals)","CREDIT","CONTRIBUTION","","","","$5.00 USD",5,-0.5,4,1934.53,"USD","hledger","hledger","gyula_weber","Gyula Weber","STRIPE","CREDITCARD",,"",,,
"2021-03-01T02:14:04","d291e330","6a63182c","Monthly contribution from Michael Martinides (Individuals)","CREDIT","CONTRIBUTION","","","","$2.00 USD",2,-0.38,1.42,1930.53,"USD","hledger","hledger","michael-martinides","Michael Martinides","STRIPE","CREDITCARD",,"",,,
"2021-03-01T02:10:18","25b349d5","298f49b0","Monthly contribution from October Swimmer (Organisations)","CREDIT","CONTRIBUTION","","","","$100.00 USD",100,-3.2,86.8,1929.11,"USD","hledger","hledger","october-swimmer","October Swimmer",,,,"",,,
"2021-03-01T01:17:50","8c839992","9a6ecf56","Monthly contribution from Anselm Peischl (Individuals)","CREDIT","CONTRIBUTION","","","","$5.00 USD",5,-0.5,4,1842.31,"USD","hledger","hledger","anselm-peischl","Anselm Peischl","STRIPE","CREDITCARD",,"",,,
"2021-02-01T20:15:29","17ee2bbe","8e182af5","Monthly contribution from Richard Kelly (Individuals)","CREDIT","CONTRIBUTION","","","","$2.00 USD",2,-0.36,1.44,1838.31,"USD","hledger","hledger","richard-kelly","Richard Kelly","STRIPE","CREDITCARD",,"",,,
"2021-02-01T17:12:16","b0801397","1d7bf0f0","Monthly contribution from Anselm Peischl (Individuals)","CREDIT","CONTRIBUTION","","","","$5.00 USD",5,-0.5,4,1836.87,"USD","hledger","hledger","anselm-peischl","Anselm Peischl","STRIPE","CREDITCARD",,"",,,
"2021-02-01T16:06:33","5352eb4e","df01ee38","Monthly contribution from Tony Xiao (Individuals)","CREDIT","CONTRIBUTION","","","","$10.00 USD",10,-0.59,8.41,1832.87,"USD","hledger","hledger","tony-xiao1","Tony Xiao","STRIPE","CREDITCARD",,"",,,
"2021-02-01T16:06:02","b289368d","74807b71","Monthly contribution from Brandon Barker (Individuals)","CREDIT","CONTRIBUTION","","","","$2.00 USD",2,-0.36,1.44,1824.46,"USD","hledger","hledger","brandonbarker","Brandon Barker","STRIPE","CREDITCARD",,"",,,
"2021-02-01T15:18:09","047dd1d3","c1643088","Monthly contribution from Rishi Hyanki (Individuals)","CREDIT","CONTRIBUTION","","","","$2.00 USD",2,-0.36,1.44,1823.02,"USD","hledger","hledger","rhyanki","Rishi Hyanki","STRIPE","CREDITCARD",,"",,,
"2021-02-01T14:04:35","d382a4f8","11b5ee8a","Monthly contribution from Jack Todaro (Individuals)","CREDIT","CONTRIBUTION","","","","$2.00 USD",2,-0.38,1.42,1821.58,"USD","hledger","hledger","jack-todaro","Jack Todaro","STRIPE","CREDITCARD",,"",,,
"2021-02-01T11:04:42","6ea9ee63","43272718","Monthly contribution from Paulo Makdisse (Individuals)","CREDIT","CONTRIBUTION","","","","$2.00 USD",2,-0.38,1.42,1820.16,"USD","hledger","hledger","paulo-makdisse","Paulo Makdisse","STRIPE","CREDITCARD",,"",,,
"2021-02-01T08:12:22","46219426","c3cc7d9c","Monthly contribution from MSATC (Individuals)","CREDIT","CONTRIBUTION","","","","$2.00 USD",2,-0.38,1.42,1818.74,"USD","hledger","hledger","msatc","MSATC","STRIPE","CREDITCARD",,"",,,
"2021-02-01T05:06:16","bb003572","98208a3d","Monthly contribution from Gyula Weber (Individuals)","CREDIT","CONTRIBUTION","","","","$5.00 USD",5,-0.5,4,1817.32,"USD","hledger","hledger","gyula_weber","Gyula Weber","STRIPE","CREDITCARD",,"",,,
"2021-02-01T02:09:35","66215be0","36169a99","Monthly contribution from Michael Martinides (Individuals)","CREDIT","CONTRIBUTION","","","","$2.00 USD",2,-0.38,1.42,1813.32,"USD","hledger","hledger","michael-martinides","Michael Martinides","STRIPE","CREDITCARD",,"",,,
"2021-02-01T02:06:47","ed7cf613","9dc1b280","Monthly contribution from October Swimmer (Organisations)","CREDIT","CONTRIBUTION","","","","$100.00 USD",100,-3.2,86.8,1811.9,"USD","hledger","hledger","october-swimmer","October Swimmer",,,,"",,,
"2021-01-28T18:39:08","64a32aa6","e66de5b6","Monthly contribution from HLO_APC (Individuals)","CREDIT","CONTRIBUTION","","","","$2.00 USD",2,-0.36,1.44,1725.1,"USD","hledger","hledger","hlo_apc","HLO_APC","STRIPE","CREDITCARD",,"",,,
"2021-01-24T16:11:06","1b225cf4","a75c815f","Monthly contribution from Writers Per Hour (Organisations)","CREDIT","CONTRIBUTION","","","","$100.00 USD",100,-4.2,85.8,1723.66,"USD","hledger","hledger","writersperhour","Writers Per Hour","STRIPE","CREDITCARD",,"",,,
"2021-01-13T00:06:51","14555825","3900149d","Monthly contribution from Andre Bubel (Individuals)","CREDIT","CONTRIBUTION","","","","$2.00 USD",2,-0.38,1.42,1637.86,"USD","hledger","hledger","andre-bubel","Andre Bubel","STRIPE","CREDITCARD",,"",,,
"2021-01-06T00:07:18","29592300","b41f49a3","Monthly contribution from MSATC (Individuals)","CREDIT","CONTRIBUTION","","","","$2.00 USD",2,-0.38,1.42,1636.44,"USD","hledger","hledger","msatc","MSATC","STRIPE","CREDITCARD",,"",,,
"2021-01-06T00:05:22","dcc5b836","82765d0f","Monthly contribution from Gyula Weber (Individuals)","CREDIT","CONTRIBUTION","","","","$5.00 USD",5,-0.5,4,1635.02,"USD","hledger","hledger","gyula_weber","Gyula Weber","STRIPE","CREDITCARD",,"",,,
"2021-01-05T03:07:57","04a23ce5","7f49b11e","Monthly contribution from Richard Kelly (Individuals)","CREDIT","CONTRIBUTION","","","","$2.00 USD",2,-0.36,1.44,1631.02,"USD","hledger","hledger","richard-kelly","Richard Kelly","STRIPE","CREDITCARD",,"",,,
"2021-01-05T02:01:58","cd83adcb","15541dc4","Monthly contribution from Paulo Makdisse (Individuals)","CREDIT","CONTRIBUTION","","","","$2.00 USD",2,-0.38,1.42,1629.58,"USD","hledger","hledger","paulo-makdisse","Paulo Makdisse","STRIPE","CREDITCARD",,"",,,
"2021-01-04T23:06:24","25d08982","a9b79fc6","Monthly contribution from Anselm Peischl (Individuals)","CREDIT","CONTRIBUTION","","","","$5.00 USD",5,-0.5,4,1628.16,"USD","hledger","hledger","anselm-peischl","Anselm Peischl","STRIPE","CREDITCARD",,"",,,
"2021-01-04T21:09:02","7c802423","5d6b14c6","Monthly contribution from Tony Xiao (Individuals)","CREDIT","CONTRIBUTION","","","","$10.00 USD",10,-0.59,8.41,1624.16,"USD","hledger","hledger","tony-xiao1","Tony Xiao","STRIPE","CREDITCARD",,"",,,
"2021-01-04T21:08:13","5150ce79","10ebda28","Monthly contribution from Brandon Barker (Individuals)","CREDIT","CONTRIBUTION","","","","$2.00 USD",2,-0.36,1.44,1615.75,"USD","hledger","hledger","brandonbarker","Brandon Barker","STRIPE","CREDITCARD",,"",,,
"2021-01-04T21:04:10","e3331a49","bbdc37aa","Monthly contribution from Rishi Hyanki (Individuals)","CREDIT","CONTRIBUTION","","","","$2.00 USD",2,-0.36,1.44,1614.31,"USD","hledger","hledger","rhyanki","Rishi Hyanki","STRIPE","CREDITCARD",,"",,,
"2021-01-04T16:13:05","6a352b85","223a64c3","Monthly contribution from Jack Todaro (Individuals)","CREDIT","CONTRIBUTION","","","","$2.00 USD",2,-0.38,1.42,1612.87,"USD","hledger","hledger","jack-todaro","Jack Todaro","STRIPE","CREDITCARD",,"",,,
"2021-01-04T10:14:48","86ae2a34","2e45bffd","Monthly contribution from Michael Martinides (Individuals)","CREDIT","CONTRIBUTION","","","","$2.00 USD",2,-0.38,1.42,1611.45,"USD","hledger","hledger","michael-martinides","Michael Martinides","STRIPE","CREDITCARD",,"",,,
"2021-01-04T10:12:27","348eb8eb","1a806c74","Monthly contribution from October Swimmer (Organisations)","CREDIT","CONTRIBUTION","","","","$100.00 USD",100,-3.2,86.8,1610.03,"USD","hledger","hledger","october-swimmer","October Swimmer",,,,"",,,
"2021-01-02T08:45:34","0a99b82a","2c61414e","Yearly contribution from incognito","CREDIT","CONTRIBUTION","","","","$50.00 USD",50,-2.25,42.75,1523.23,"USD","hledger","hledger","incognito-6a1e7e79","incognito","STRIPE","CREDITCARD",,"",,,
"2021-01-01T18:55:22","924b6844","7f46283d","Contribution from Guest","CREDIT","CONTRIBUTION","","","","$50.00 USD",50,-1.75,43.25,1480.48,"USD","hledger","hledger","guest-a949b49b","Guest","PAYPAL","PAYMENT",,"",,,
"2020-12-31T13:04:37","2784404e","ea85f55b","Yearly contribution from Damien Cassou","CREDIT","CONTRIBUTION","","","","$20.00 USD",20,-1.08,16.92,1437.23,"USD","hledger","hledger","damien-cassou","Damien Cassou",,,,"",,,
"2020-12-29T19:14:56","7dd78ab7","4c541dc4","Contribution from Michael Manganiello","CREDIT","CONTRIBUTION","","","","$5.38 USD",5.38,-0.54,4.3,1420.31,"USD","hledger","hledger","guest-c173624c","Michael Manganiello","PAYPAL","PAYMENT",,"",,,
"2020-12-29T11:48:38","3152ec4a","6d17ee19","Monthly contribution from Damien Cassou (Individuals)","CREDIT","CONTRIBUTION","","","","$2.00 USD",2,-0.38,1.42,1416.01,"USD","hledger","hledger","damien-cassou","Damien Cassou",,,,"",,,
"2020-12-13T23:06:03","a6b81416","5f3e18ae","Contribution from Martin Rio","CREDIT","CONTRIBUTION","","","","$100.00 USD",100,-3.2,86.8,1414.59,"USD","hledger","hledger","guest-87be5777","Martin Rio","PAYPAL","PAYMENT",,"",,,
"2020-12-01T20:08:32","7b0ece2f","e7253946","Monthly contribution from Paulo Makdisse (Individuals)","CREDIT","CONTRIBUTION","","","","$2.00 USD",2,-0.38,1.42,1327.79,"USD","hledger","hledger","paulo-makdisse","Paulo Makdisse","STRIPE","CREDITCARD",,"",,,
"2020-12-01T19:12:18","29aa99bd","690c491c","Monthly contribution from HLO_APC (Individuals)","CREDIT","CONTRIBUTION","","","","$2.00 USD",2,-0.36,1.44,1326.37,"USD","hledger","hledger","hlo_apc","HLO_APC","STRIPE","CREDITCARD",,"",,,
"2020-12-01T17:05:54","7ae392ba","1ad55585","Monthly contribution from Brandon Barker (Individuals)","CREDIT","CONTRIBUTION","","","","$2.00 USD",2,-0.36,1.44,1324.93,"USD","hledger","hledger","brandonbarker","Brandon Barker","STRIPE","CREDITCARD",,"",,,
"2020-12-01T16:02:33","209d5df6","1379e641","Monthly contribution from Tony Xiao (Individuals)","CREDIT","CONTRIBUTION","","","","$10.00 USD",10,-0.59,8.41,1323.49,"USD","hledger","hledger","tony-xiao1","Tony Xiao","STRIPE","CREDITCARD",,"",,,
"2020-12-01T15:13:58","5123b3a8","e21825e3","Monthly contribution from Rishi Hyanki (Individuals)","CREDIT","CONTRIBUTION","","","","$2.00 USD",2,-0.36,1.44,1315.08,"USD","hledger","hledger","rhyanki","Rishi Hyanki","STRIPE","CREDITCARD",,"",,,
"2020-12-01T14:07:57","26ce6589","161a083e","Monthly contribution from Andre Bubel (Individuals)","CREDIT","CONTRIBUTION","","","","$2.00 USD",2,-0.38,1.42,1313.64,"USD","hledger","hledger","andre-bubel","Andre Bubel","STRIPE","CREDITCARD",,"",,,
"2020-12-01T11:13:25","1fe33b42","9c57a97e","Monthly contribution from Jack Todaro (Individuals)","CREDIT","CONTRIBUTION","","","","$2.00 USD",2,-0.38,1.42,1312.22,"USD","hledger","hledger","jack-todaro","Jack Todaro","STRIPE","CREDITCARD",,"",,,
"2020-12-01T08:23:32","c43260f9","fdadff6b","Monthly contribution from Michael Martinides (Individuals)","CREDIT","CONTRIBUTION","","","","$2.00 USD",2,-0.38,1.42,1310.8,"USD","hledger","hledger","michael-martinides","Michael Martinides","STRIPE","CREDITCARD",,"",,,
"2020-12-01T08:13:52","4ffa98c2","644301c8","Monthly contribution from October Swimmer (Organisations)","CREDIT","CONTRIBUTION","","","","$100.00 USD",100,-3.2,86.8,1309.38,"USD","hledger","hledger","october-swimmer","October Swimmer",,,,"",,,
"2020-11-29T10:13:26","d45383e2","cf5d3bc1","Monthly contribution from Richard Kelly (Individuals)","CREDIT","CONTRIBUTION","","","","$2.00 USD",2,-0.36,1.44,1222.58,"USD","hledger","hledger","richard-kelly","Richard Kelly","STRIPE","CREDITCARD",,"",,,
"2020-11-26T12:00:39","6f583f6d","5270afb4","Monthly contribution from MSATC (Individuals)","CREDIT","CONTRIBUTION","","","","$2.00 USD",2,-0.38,1.42,1221.14,"USD","hledger","hledger","msatc","MSATC","STRIPE","CREDITCARD",,"",,,
"2020-11-18T17:12:41","41b5a8bd","091635bf","Monthly contribution from Gyula Weber (Individuals)","CREDIT","CONTRIBUTION","","","","$5.00 USD",5,-0.5,4,1219.72,"USD","hledger","hledger","gyula_weber","Gyula Weber","STRIPE","CREDITCARD",,"",,,
"2020-11-01T13:06:39","cd4d5a8e","99754470","Monthly contribution from Paulo Makdisse (Individuals)","CREDIT","CONTRIBUTION","","","","$2.00 USD",2,-0.38,1.42,1215.72,"USD","hledger","hledger","paulo-makdisse","Paulo Makdisse","STRIPE","CREDITCARD",,"",,,
"2020-11-01T12:09:44","7ed8e956","7b1a4b21","Monthly contribution from HLO_APC (Individuals)","CREDIT","CONTRIBUTION","","","","$2.00 USD",2,-0.36,1.44,1214.3,"USD","hledger","hledger","hlo_apc","HLO_APC","STRIPE","CREDITCARD",,"",,,
"2020-11-01T09:12:07","c45133b8","4a875731","Monthly contribution from Brandon Barker (Individuals)","CREDIT","CONTRIBUTION","","","","$2.00 USD",2,-0.36,1.44,1212.86,"USD","hledger","hledger","brandonbarker","Brandon Barker","STRIPE","CREDITCARD",,"",,,
"2020-11-01T08:13:18","dd670d22","9eb97e9b","Monthly contribution from Tony Xiao (Individuals)","CREDIT","CONTRIBUTION","","","","$10.00 USD",10,-0.59,8.41,1211.42,"USD","hledger","hledger","tony-xiao1","Tony Xiao","STRIPE","CREDITCARD",,"",,,
"2020-11-01T08:11:24","02178db6","3e85b2f2","Monthly contribution from Rishi Hyanki (Individuals)","CREDIT","CONTRIBUTION","","","","$2.00 USD",2,-0.36,1.44,1203.01,"USD","hledger","hledger","rhyanki","Rishi Hyanki","STRIPE","CREDITCARD",,"",,,
"2020-11-01T07:12:37","f685ddbf","2c67d625","Monthly contribution from Andre Bubel (Individuals)","CREDIT","CONTRIBUTION","","","","$2.00 USD",2,-0.38,1.42,1201.57,"USD","hledger","hledger","andre-bubel","Andre Bubel","STRIPE","CREDITCARD",,"",,,
"2020-11-01T05:10:18","98833a34","6fe82476","Monthly contribution from Jack Todaro (Individuals)","CREDIT","CONTRIBUTION","","","","$2.00 USD",2,-0.38,1.42,1200.15,"USD","hledger","hledger","jack-todaro","Jack Todaro","STRIPE","CREDITCARD",,"",,,
"2020-11-01T01:07:04","1186e132","dab72889","Monthly contribution from Michael Martinides (Individuals)","CREDIT","CONTRIBUTION","","","","$2.00 USD",2,-0.38,1.42,1198.73,"USD","hledger","hledger","michael-martinides","Michael Martinides","STRIPE","CREDITCARD",,"",,,
"2020-11-01T01:05:11","1fc17fb9","5bbb8550","Monthly contribution from October Swimmer (Organisations)","CREDIT","CONTRIBUTION","","","","$100.00 USD",100,-3.2,86.8,1197.31,"USD","hledger","hledger","october-swimmer","October Swimmer",,,,"",,,
"2020-10-04T14:48:55","b78bf78b","540b003a","Monthly contribution from Tony Xiao (Individuals)","CREDIT","CONTRIBUTION","","","","$10.00 USD",10,-0.59,8.41,1110.51,"USD","hledger","hledger","tony-xiao1","Tony Xiao","STRIPE","CREDITCARD",,"",,,
"2020-10-01T07:11:59","fc61589f","8f2cb497","Monthly contribution from Jack Todaro (Individuals)","CREDIT","CONTRIBUTION","","","","$2.00 USD",2,-0.38,1.42,1102.1,"USD","hledger","hledger","jack-todaro","Jack Todaro","STRIPE","CREDITCARD",,"",,,
"2020-10-01T04:19:32","66dd2418","0b047c25","Monthly contribution from Paulo Makdisse (Individuals)","CREDIT","CONTRIBUTION","","","","$2.00 USD",2,-0.38,1.42,1100.68,"USD","hledger","hledger","paulo-makdisse","Paulo Makdisse","STRIPE","CREDITCARD",,"",,,
"2020-10-01T04:13:39","9e0c4fe4","6cf015c3","Monthly contribution from HLO_APC (Individuals)","CREDIT","CONTRIBUTION","","","","$2.00 USD",2,-0.36,1.44,1099.26,"USD","hledger","hledger","hlo_apc","HLO_APC","STRIPE","CREDITCARD",,"",,,
"2020-10-01T03:07:01","d8be138a","58a41f59","Monthly contribution from Brandon Barker (Individuals)","CREDIT","CONTRIBUTION","","","","$2.00 USD",2,-0.36,1.44,1097.82,"USD","hledger","hledger","brandonbarker","Brandon Barker","STRIPE","CREDITCARD",,"",,,
"2020-10-01T02:15:54","ff745054","fee9006f","Monthly contribution from Rishi Hyanki (Individuals)","CREDIT","CONTRIBUTION","","","","$5.00 USD",5,-0.45,4.05,1096.38,"USD","hledger","hledger","rhyanki","Rishi Hyanki","STRIPE","CREDITCARD",,"",,,
"2020-10-01T02:12:31","4a35817c","a61372a2","Monthly contribution from Andre Bubel (Individuals)","CREDIT","CONTRIBUTION","","","","$2.00 USD",2,-0.38,1.42,1092.33,"USD","hledger","hledger","andre-bubel","Andre Bubel","STRIPE","CREDITCARD",,"",,,
"2020-10-01T00:16:15","e179305e","e3f3378d","Monthly contribution from Michael Martinides (Individuals)","CREDIT","CONTRIBUTION","","","","$2.00 USD",2,-0.38,1.42,1090.91,"USD","hledger","hledger","michael-martinides","Michael Martinides","STRIPE","CREDITCARD",,"",,,
"2020-10-01T00:15:11","e604ba47","d04acf57","Monthly contribution from October Swimmer (Organisations)","CREDIT","CONTRIBUTION","","","","$100.00 USD",100,-3.2,86.8,1089.49,"USD","hledger","hledger","october-swimmer","October Swimmer",,,,"",,,
"2020-09-09T07:03:39","be293236","3a247930","Monthly contribution from Andre Bubel (Individuals)","CREDIT","CONTRIBUTION","","","","$2.00 USD",2,-0.38,1.42,1002.69,"USD","hledger","hledger","andre-bubel","Andre Bubel","STRIPE","CREDITCARD",,"",,,
"2020-09-01T09:24:10","31e213a4","ab488bea","Monthly contribution from October Swimmer (Organisations)","CREDIT","CONTRIBUTION","","","","$100.00 USD",100,-3.2,86.8,1001.27,"USD","hledger","hledger","october-swimmer","October Swimmer",,,,"",,,
"2020-09-01T09:23:56","0f7342b1","2c5a052c","Monthly contribution from Paulo Makdisse (Individuals)","CREDIT","CONTRIBUTION","","","","$2.00 USD",2,-0.38,1.42,914.47,"USD","hledger","hledger","paulo-makdisse","Paulo Makdisse","STRIPE","CREDITCARD",,"",,,
"2020-09-01T09:20:42","6545c8a7","b8fedc62","Monthly contribution from HLO_APC (Individuals)","CREDIT","CONTRIBUTION","","","","$2.00 USD",2,-0.36,1.44,913.05,"USD","hledger","hledger","hlo_apc","HLO_APC","STRIPE","CREDITCARD",,"",,,
"2020-09-01T08:53:21","d8e49f82","462215a9","Monthly contribution from Brandon Barker (Individuals)","CREDIT","CONTRIBUTION","","","","$2.00 USD",2,-0.36,1.44,911.61,"USD","hledger","hledger","brandonbarker","Brandon Barker","STRIPE","CREDITCARD",,"",,,
"2020-09-01T08:48:36","22887259","4f54c2e3","Monthly contribution from Rishi Hyanki (Individuals)","CREDIT","CONTRIBUTION","","","","$5.00 USD",5,-0.45,4.05,910.17,"USD","hledger","hledger","rhyanki","Rishi Hyanki","STRIPE","CREDITCARD",,"",,,
"2020-09-01T08:21:39","7e987f7a","77f00977","Monthly contribution from Michael Martinides (Individuals)","CREDIT","CONTRIBUTION","","","","$2.00 USD",2,-0.38,1.42,906.12,"USD","hledger","hledger","michael-martinides","Michael Martinides","STRIPE","CREDITCARD",,"",,,
"2020-08-28T08:02:11","4398aaa4","06a6afae","Monthly contribution from Jack Todaro (Individuals)","CREDIT","CONTRIBUTION","","","","$2.00 USD",2,-0.38,1.42,904.7,"USD","hledger","hledger","jack-todaro","Jack Todaro","STRIPE","CREDITCARD",,"",,,
"2020-08-11T05:03:21","5f579fbf","8b96fcc1","Monthly contribution from Paulo Makdisse (Individuals)","CREDIT","CONTRIBUTION","","","","$2.00 USD",2,-0.38,1.42,903.28,"USD","hledger","hledger","paulo-makdisse","Paulo Makdisse","STRIPE","CREDITCARD",,"",,,
"2020-08-10T05:01:45","3bae8ff3","78164a31","Monthly contribution from Andre Bubel (Individuals)","CREDIT","CONTRIBUTION","","","","$2.00 USD",2,-0.38,1.42,901.86,"USD","hledger","hledger","andre-bubel","Andre Bubel","STRIPE","CREDITCARD",,"",,,
"2020-08-03T05:17:07","c4a536e2","9ddcfbbe","Monthly contribution from October Swimmer (Organisations)","CREDIT","CONTRIBUTION","","","","$100.00 USD",100,-3.2,86.8,900.44,"USD","hledger","hledger","october-swimmer","October Swimmer",,,,"",,,
"2020-08-03T05:10:35","12f0ffb9","3c885168","Monthly contribution from HLO_APC (Individuals)","CREDIT","CONTRIBUTION","","","","$2.00 USD",2,-0.36,1.44,813.64,"USD","hledger","hledger","hlo_apc","HLO_APC","STRIPE","CREDITCARD",,"",,,
"2020-08-02T05:13:48","128cb2e9","753a9e41","Monthly contribution from Brandon Barker (Individuals)","CREDIT","CONTRIBUTION","","","","$2.00 USD",2,-0.36,1.44,812.2,"USD","hledger","hledger","brandonbarker","Brandon Barker","STRIPE","CREDITCARD",,"",,,
"2020-08-01T10:57:38","082c6824","c630adf4","Monthly contribution from Rishi Hyanki (Individuals)","CREDIT","CONTRIBUTION","","","","$5.00 USD",5,-0.45,4.05,810.76,"USD","hledger","hledger","rhyanki","Rishi Hyanki","STRIPE","CREDITCARD",,"",,,
"2020-08-01T10:41:50","55372e8a","f1d26dfc","Monthly contribution from Michael Martinides (Individuals)","CREDIT","CONTRIBUTION","","","","$2.00 USD",2,-0.38,1.42,806.71,"USD","hledger","hledger","michael-martinides","Michael Martinides","STRIPE","CREDITCARD",,"",,,
"2020-07-03T05:25:06","09014e5a","8e244cc7","Monthly contribution from October Swimmer (Organisations)","CREDIT","CONTRIBUTION","","","","$100.00 USD",100,-3.2,86.8,805.29,"USD","hledger","hledger","october-swimmer","October Swimmer",,,,"",,,
"2020-07-03T05:24:48","1869fcc6","5023de21","Monthly contribution from Paulo Makdisse (Individuals)","CREDIT","CONTRIBUTION","","","","$2.00 USD",2,-0.38,1.42,718.49,"USD","hledger","hledger","paulo-makdisse","Paulo Makdisse","STRIPE","CREDITCARD",,"",,,
"2020-07-03T05:18:30","b28186ca","6885ee37","Monthly contribution from HLO_APC (Individuals)","CREDIT","CONTRIBUTION","","","","$2.00 USD",2,-0.36,1.44,717.07,"USD","hledger","hledger","hlo_apc","HLO_APC","STRIPE","CREDITCARD",,"",,,
"2020-07-02T05:20:42","94d998f8","512777d5","Monthly contribution from Rishi Hyanki (Individuals)","CREDIT","CONTRIBUTION","","","","$5.00 USD",5,-0.45,4.05,715.63,"USD","hledger","hledger","rhyanki","Rishi Hyanki","STRIPE","CREDITCARD",,"",,,
"2020-07-01T05:17:14","2978d570","5b5f815b","Monthly contribution from Andre Bubel (Individuals)","CREDIT","CONTRIBUTION","","","","$2.00 USD",2,-0.38,1.42,711.58,"USD","hledger","hledger","andre-bubel","Andre Bubel","STRIPE","CREDITCARD",,"",,,
"2020-07-01T05:12:24","c876748a","436444c5","Monthly contribution from Michael Martinides (Individuals)","CREDIT","CONTRIBUTION","","","","$2.00 USD",2,-0.38,1.42,710.16,"USD","hledger","hledger","michael-martinides","Michael Martinides","STRIPE","CREDITCARD",,"",,,
"2020-07-01T05:07:47","11a83cac","1c8afc6b","Monthly contribution from Brandon Barker (Individuals)","CREDIT","CONTRIBUTION","","","","$2.00 USD",2,-0.36,1.44,708.74,"USD","hledger","hledger","brandonbarker","Brandon Barker","STRIPE","CREDITCARD",,"",,,
"2020-06-16T05:01:39","41f911d9","78ae4ca1","Monthly contribution from Andre Bubel (Individuals)","CREDIT","CONTRIBUTION","","","","$2.00 USD",2,-0.38,1.42,707.3,"USD","hledger","hledger","andre-bubel","Andre Bubel","STRIPE","CREDITCARD",,"",,,
"2020-06-03T05:23:47","65bd3280","c1e85752","Monthly contribution from October Swimmer (Organisations)","CREDIT","CONTRIBUTION","","","","$100.00 USD",100,-3.2,86.8,705.88,"USD","hledger","hledger","october-swimmer","October Swimmer",,,,"",,,
"2020-06-03T05:23:21","8fde80c3","86f0f055","Monthly contribution from Paulo Makdisse (Individuals)","CREDIT","CONTRIBUTION","","","","$2.00 USD",2,-0.38,1.42,619.08,"USD","hledger","hledger","paulo-makdisse","Paulo Makdisse","STRIPE","CREDITCARD",,"",,,
"2020-06-03T05:16:29","ad48bdfa","00b263c0","Monthly contribution from HLO_APC (Individuals)","CREDIT","CONTRIBUTION","","","","$2.00 USD",2,-0.36,1.44,617.66,"USD","hledger","hledger","hlo_apc","HLO_APC","STRIPE","CREDITCARD",,"",,,
"2020-06-02T05:08:53","fe2707b1","1cbd40cd","Monthly contribution from Rishi Hyanki (Individuals)","CREDIT","CONTRIBUTION","","","","$5.00 USD",5,-0.45,4.05,616.22,"USD","hledger","hledger","rhyanki","Rishi Hyanki","STRIPE","CREDITCARD",,"",,,
"2020-06-01T05:12:24","8d951d05","fbaf99a4","Monthly contribution from Michael Martinides (Individuals)","CREDIT","CONTRIBUTION","","","","$2.00 USD",2,-0.38,1.42,612.17,"USD","hledger","hledger","michael-martinides","Michael Martinides","STRIPE","CREDITCARD",,"",,,
"2020-06-01T05:08:01","791f3d20","8133c4c8","Monthly contribution from Brandon Barker (Individuals)","CREDIT","CONTRIBUTION","","","","$2.00 USD",2,-0.36,1.44,610.75,"USD","hledger","hledger","brandonbarker","Brandon Barker","STRIPE","CREDITCARD",,"",,,
"2020-05-22T05:00:57","5035c6ea","52c6d258","Monthly contribution from Andre Bubel (Individuals)","CREDIT","CONTRIBUTION","","","","$2.00 USD",2,-0.38,1.42,609.31,"USD","hledger","hledger","andre-bubel","Andre Bubel","STRIPE","CREDITCARD",,"",,,
"2020-05-18T06:27:48","70e8bc2f","f04ca01b","Contribution from incognito","CREDIT","CONTRIBUTION","","","","$20.00 USD",20,-0.88,17.12,607.89,"USD","hledger","hledger","incognito-59e742bc","incognito","PAYPAL","PAYMENT",,"",,,
"2020-05-04T05:16:02","0ecf1af6","c84e6735","Monthly contribution from October Swimmer (Organisations)","CREDIT","CONTRIBUTION","","","","$100.00 USD",100,-3.2,86.8,590.77,"USD","hledger","hledger","october-swimmer","October Swimmer",,,,"",,,
"2020-05-04T05:15:24","b27df954","a701c57b","Monthly contribution from Paulo Makdisse (Individuals)","CREDIT","CONTRIBUTION","","","","$2.00 USD",2,-0.38,1.42,503.97,"USD","hledger","hledger","paulo-makdisse","Paulo Makdisse","STRIPE","CREDITCARD",,"",,,
"2020-05-03T05:02:56","a0b47aed","012a0cde","Monthly contribution from Rishi Hyanki (Individuals)","CREDIT","CONTRIBUTION","","","","$5.00 USD",5,-0.45,4.05,502.55,"USD","hledger","hledger","rhyanki","Rishi Hyanki","STRIPE","CREDITCARD",,"",,,
"2020-05-02T22:16:53","2f6393c5","d2604038","Monthly contribution from HLO_APC (Individuals)","CREDIT","CONTRIBUTION","","","","$2.00 USD",2,-0.36,1.44,498.5,"USD","hledger","hledger","hlo_apc","HLO_APC","STRIPE","CREDITCARD",,"",,,
"2020-05-02T10:18:02","86bff4e2","6e8376d0","Monthly contribution from Michael Martinides (Individuals)","CREDIT","CONTRIBUTION","","","","$2.00 USD",2,-0.38,1.42,497.06,"USD","hledger","hledger","michael-martinides","Michael Martinides","STRIPE","CREDITCARD",,"",,,
"2020-05-01T05:09:50","203dd78b","489fb55f","Monthly contribution from Brandon Barker (Individuals)","CREDIT","CONTRIBUTION","","","","$2.00 USD",2,-0.36,1.44,495.64,"USD","hledger","hledger","brandonbarker","Brandon Barker","STRIPE","CREDITCARD",,"",,,
"2020-04-10T21:28:10","33081501","78009d44","Monthly contribution from October Swimmer (Organisations)","CREDIT","CONTRIBUTION","","","","$100.00 USD",100,-3.2,86.8,494.2,"USD","hledger","hledger","october-swimmer","October Swimmer",,,,"",,,
"2020-04-09T05:01:47","6082be25","3b0e9818","Monthly contribution from Andre Bubel (Individuals)","CREDIT","CONTRIBUTION","","","","$2.00 USD",2,-0.38,1.42,407.4,"USD","hledger","hledger","andre-bubel","Andre Bubel","STRIPE","CREDITCARD",,"",,,
"2020-04-08T20:17:27","421a7fad","5acdfb24","Monthly contribution from Paulo Makdisse (Individuals)","CREDIT","CONTRIBUTION","","","","$2.00 USD",2,-0.38,1.42,405.98,"USD","hledger","hledger","paulo-makdisse","Paulo Makdisse","STRIPE","CREDITCARD",,"",,,
"2020-04-03T05:02:23","c2bd7485","fc2bb1b7","Monthly contribution from Rishi Hyanki (Individuals)","CREDIT","CONTRIBUTION","","","","$5.00 USD",5,-0.45,4.05,404.56,"USD","hledger","hledger","rhyanki","Rishi Hyanki","STRIPE","CREDITCARD",,"",,,
"2020-04-01T05:19:47","137cda81","e83eae62","Monthly contribution from Michael Martinides (Individuals)","CREDIT","CONTRIBUTION","","","","$2.00 USD",2,-0.38,1.42,400.51,"USD","hledger","hledger","michael-martinides","Michael Martinides","STRIPE","CREDITCARD",,"",,,
"2020-04-01T05:12:41","1c741c17","30818e53","Monthly contribution from Brandon Barker (Individuals)","CREDIT","CONTRIBUTION","","","","$2.00 USD",2,-0.36,1.44,399.09,"USD","hledger","hledger","brandonbarker","Brandon Barker","STRIPE","CREDITCARD",,"",,,
"2020-03-02T05:25:25","950e2ae8","33b41f8b","Monthly contribution from Rishi Hyanki (Individuals)","CREDIT","CONTRIBUTION","","","","$5.00 USD",5,-0.45,4.05,397.65,"USD","hledger","hledger","rhyanki","Rishi Hyanki","STRIPE","CREDITCARD",,"",,,
"2020-03-01T05:22:42","2e1b61c0","fd5b51b6","Monthly contribution from Andre Bubel (Individuals)","CREDIT","CONTRIBUTION","","","","$2.00 USD",2,-0.38,1.42,393.6,"USD","hledger","hledger","andre-bubel","Andre Bubel","STRIPE","CREDITCARD",,"",,,
"2020-03-01T05:13:34","270c8123","62e745e1","Monthly contribution from Michael Martinides (Individuals)","CREDIT","CONTRIBUTION","","","","$2.00 USD",2,-0.38,1.42,392.18,"USD","hledger","hledger","michael-martinides","Michael Martinides","STRIPE","CREDITCARD",,"",,,
"2020-03-01T05:08:14","de44bf1c","d445f221","Monthly contribution from Brandon Barker (Individuals)","CREDIT","CONTRIBUTION","","","","$2.00 USD",2,-0.36,1.44,390.76,"USD","hledger","hledger","brandonbarker","Brandon Barker","STRIPE","CREDITCARD",,"",,,
"2020-02-03T05:15:41","c99aeeeb","e2d0ff57","Monthly contribution from Andre Bubel (Individuals)","CREDIT","CONTRIBUTION","","","","$2.00 USD",2,-0.38,1.42,389.32,"USD","hledger","hledger","andre-bubel","Andre Bubel","STRIPE","CREDITCARD",,"",,,
"2020-02-02T05:11:48","27913cd5","df6b8fc1","Monthly contribution from Rishi Hyanki (Individuals)","CREDIT","CONTRIBUTION","","","","$5.00 USD",5,-0.45,4.05,387.9,"USD","hledger","hledger","rhyanki","Rishi Hyanki","STRIPE","CREDITCARD",,"",,,
"2020-02-01T05:18:16","16cf280c","c402253f","Monthly contribution from Michael Martinides (Individuals)","CREDIT","CONTRIBUTION","","","","$2.00 USD",2,-0.38,1.42,383.85,"USD","hledger","hledger","michael-martinides","Michael Martinides","STRIPE","CREDITCARD",,"",,,
"2020-02-01T05:10:37","6c12380c","7b38c7c9","Monthly contribution from Brandon Barker (Individuals)","CREDIT","CONTRIBUTION","","","","$2.00 USD",2,-0.36,1.44,382.43,"USD","hledger","hledger","brandonbarker","Brandon Barker","STRIPE","CREDITCARD",,"",,,
"2020-01-09T16:43:03","f2e4afc1","c48e4a2a","Monthly contribution from Brandon Barker (Individuals)","CREDIT","CONTRIBUTION","","","","$2.00 USD",2,-0.36,1.44,380.99,"USD","hledger","hledger","brandonbarker","Brandon Barker","STRIPE","CREDITCARD",,"",,,
"2020-01-03T05:13:56","511e3ee1","a12f6292","Monthly contribution from Andre Bubel (Individuals)","CREDIT","CONTRIBUTION","","","","$2.00 USD",2,-0.38,1.42,379.55,"USD","hledger","hledger","andre-bubel","Andre Bubel","STRIPE","CREDITCARD",,"",,,
"2020-01-01T05:20:36","f7b986df","7455c303","Monthly contribution from Rishi Hyanki (Individuals)","CREDIT","CONTRIBUTION","","","","$5.00 USD",5,-0.45,4.05,378.13,"USD","hledger","hledger","rhyanki","Rishi Hyanki","STRIPE","CREDITCARD",,"",,,
"2020-01-01T05:16:30","3c1333e4","dfc666a3","Monthly contribution from Michael Martinides (Individuals)","CREDIT","CONTRIBUTION","","","","$2.00 USD",2,-0.38,1.42,374.08,"USD","hledger","hledger","michael-martinides","Michael Martinides","STRIPE","CREDITCARD",,"",,,
"2019-12-03T05:12:03","8b2c40dd","109d608c","Monthly contribution from Andre Bubel (Individuals)","CREDIT","CONTRIBUTION","","","","$2.00 USD",2,-0.38,1.42,372.66,"USD","hledger","hledger","andre-bubel","Andre Bubel","STRIPE","CREDITCARD",,"",,,
"2019-12-01T05:18:53","66b262b9","8940799c","Monthly contribution from Rishi Hyanki (Individuals)","CREDIT","CONTRIBUTION","","","","$5.00 USD",5,-0.45,4.05,371.24,"USD","hledger","hledger","rhyanki","Rishi Hyanki","STRIPE","CREDITCARD",,"",,,
"2019-12-01T05:14:25","c5eced93","ab2e4dc8","Monthly contribution from Michael Martinides (Individuals)","CREDIT","CONTRIBUTION","","","","$2.00 USD",2,-0.38,1.42,367.19,"USD","hledger","hledger","michael-martinides","Michael Martinides","STRIPE","CREDITCARD",,"",,,
"2019-11-01T17:08:05","8d752de4","0c31294b","Monthly contribution from Andre Bubel (Individuals)","CREDIT","CONTRIBUTION","","","","$2.00 USD",2,-0.38,1.42,365.77,"USD","hledger","hledger","andre-bubel","Andre Bubel","STRIPE","CREDITCARD",,"",,,
"2019-11-01T14:29:54","d92cc48d","b5450f15","Monthly contribution from Rishi Hyanki (Individuals)","CREDIT","CONTRIBUTION","","","","$5.00 USD",5,-0.45,4.05,364.35,"USD","hledger","hledger","rhyanki","Rishi Hyanki","STRIPE","CREDITCARD",,"",,,
"2019-11-01T14:24:25","5e8dc01e","a03df435","Monthly contribution from Michael Martinides (Individuals)","CREDIT","CONTRIBUTION","","","","$2.00 USD",2,-0.38,1.42,360.3,"USD","hledger","hledger","michael-martinides","Michael Martinides","STRIPE","CREDITCARD",,"",,,
"2019-10-01T05:53:44","9eec1d8a","4997893f","Monthly contribution from Andre Bubel (Individuals)","CREDIT","CONTRIBUTION","","","","$2.00 USD",2,-0.38,1.42,358.88,"USD","hledger","hledger","andre-bubel","Andre Bubel","STRIPE","CREDITCARD",,"",,,
"2019-10-01T05:29:48","be7fb74d","a4321cdf","Monthly contribution from Rishi Hyanki (Individuals)","CREDIT","CONTRIBUTION","","","","$5.00 USD",5,-0.45,4.05,357.46,"USD","hledger","hledger","rhyanki","Rishi Hyanki","STRIPE","CREDITCARD",,"",,,
"2019-10-01T05:26:24","d8017cfb","87f75936","Monthly contribution from Michael Martinides (Individuals)","CREDIT","CONTRIBUTION","","","","$2.00 USD",2,-0.38,1.42,353.41,"USD","hledger","hledger","michael-martinides","Michael Martinides","STRIPE","CREDITCARD",,"",,,
"2019-09-27T06:44:48","97a1f5b3","0826901e","Monthly contribution from Rishi Hyanki (Individuals)","CREDIT","CONTRIBUTION","","","","$5.00 USD",5,-0.45,4.05,351.99,"USD","hledger","hledger","rhyanki","Rishi Hyanki","STRIPE","CREDITCARD",,"",,,
"2019-09-01T05:45:26","e4d0a169","f7d293fd","Monthly contribution from Andre Bubel (Individuals)","CREDIT","CONTRIBUTION","","","","$2.00 USD",2,-0.38,1.42,347.94,"USD","hledger","hledger","andre-bubel","Andre Bubel","STRIPE","CREDITCARD",,"",,,
"2019-09-01T05:41:53","93f0a3e7","d3d78768","Monthly contribution from Colton Lewis (Individuals)","CREDIT","CONTRIBUTION","","","","$5.00 USD",5,-0.45,4.05,346.52,"USD","hledger","hledger","colton-lewis","Colton Lewis","OPENCOLLECTIVE","GIFTCARD",,"",,,
"2019-09-01T05:28:30","ca75f694","69b52407","Monthly contribution from Michael Martinides (Individuals)","CREDIT","CONTRIBUTION","","","","$2.00 USD",2,-0.38,1.42,342.47,"USD","hledger","hledger","michael-martinides","Michael Martinides","STRIPE","CREDITCARD",,"",,,
"2019-08-01T05:38:18","36f70863","330262a5","Monthly contribution from Andre Bubel (Individuals)","CREDIT","CONTRIBUTION","","","","$2.00 USD",2,-0.38,1.42,341.05,"USD","hledger","hledger","andre-bubel","Andre Bubel","STRIPE","CREDITCARD",,"",,,
"2019-08-01T05:35:09","97b86133","7ad4cab3","Monthly contribution from Colton Lewis (Individuals)","CREDIT","CONTRIBUTION","","","","$5.00 USD",5,-0.45,4.05,339.63,"USD","hledger","hledger","colton-lewis","Colton Lewis","OPENCOLLECTIVE","GIFTCARD",,"",,,
"2019-08-01T05:33:07","721a1c34","a2c04d39","Monthly contribution from Everyrole (Individuals)","CREDIT","CONTRIBUTION","","","","$2.00 USD",2,-0.38,1.42,335.58,"USD","hledger","hledger","everyrole","Everyrole","STRIPE","CREDITCARD",,"",,,
"2019-08-01T05:26:13","c5d23973","fb7372df","Monthly contribution from Michael Martinides (Individuals)","CREDIT","CONTRIBUTION","","","","$2.00 USD",2,-0.38,1.42,334.16,"USD","hledger","hledger","michael-martinides","Michael Martinides","STRIPE","CREDITCARD",,"",,,
"2019-07-26T11:21:08","c7e5557d","466c8f82","Monthly contribution from Everyrole (Individuals)","CREDIT","CONTRIBUTION","","","","$2.00 USD",2,-0.38,1.42,332.74,"USD","hledger","hledger","everyrole","Everyrole","STRIPE","CREDITCARD",,"",,,
"2019-07-01T05:38:46","0ccf2f30","a96a62c2","Monthly contribution from Andre Bubel (Individuals)","CREDIT","CONTRIBUTION","","","","$2.00 USD",2,-0.38,1.42,331.32,"USD","hledger","hledger","andre-bubel","Andre Bubel","STRIPE","CREDITCARD",,"",,,
"2019-07-01T05:35:28","989d5662","244f804e","Monthly contribution from Colton Lewis (Individuals)","CREDIT","CONTRIBUTION","","","","$5.00 USD",5,-0.45,4.05,329.9,"USD","hledger","hledger","colton-lewis","Colton Lewis","OPENCOLLECTIVE","GIFTCARD",,"",,,
"2019-07-01T05:27:25","db9552e5","6040b683","Monthly contribution from Michael Martinides (Individuals)","CREDIT","CONTRIBUTION","","","","$2.00 USD",2,-0.38,1.42,325.85,"USD","hledger","hledger","michael-martinides","Michael Martinides","STRIPE","CREDITCARD",,"",,,
"2019-06-01T05:30:36","c262fb06","1285317a","Monthly contribution from Andre Bubel (Individuals)","CREDIT","CONTRIBUTION","","","","$2.00 USD",2,-0.38,1.42,324.43,"USD","hledger","hledger","andre-bubel","Andre Bubel","STRIPE","CREDITCARD",,"",,,
"2019-06-01T05:27:19","e2d3b640","045fd7ea","Monthly contribution from Colton Lewis (Individuals)","CREDIT","CONTRIBUTION","","","","$5.00 USD",5,-0.45,4.05,323.01,"USD","hledger","hledger","colton-lewis","Colton Lewis","OPENCOLLECTIVE","GIFTCARD",,"",,,
"2019-06-01T05:23:05","a90bfa46","9763d36d","Monthly contribution from Michael Martinides (Individuals)","CREDIT","CONTRIBUTION","","","","$2.00 USD",2,-0.38,1.42,318.96,"USD","hledger","hledger","michael-martinides","Michael Martinides","STRIPE","CREDITCARD",,"",,,
"2019-05-21T17:28:27","a50bc155","1a88cc3e","Monthly contribution from Colton Lewis (Individuals)","CREDIT","CONTRIBUTION","","","","$5.00 USD",5,-0.45,4.05,317.54,"USD","hledger","hledger","colton-lewis","Colton Lewis","OPENCOLLECTIVE","GIFTCARD",,"",,,
"2019-05-01T05:38:06","42a49bc8","d1f0eecc","Monthly contribution from Andre Bubel (Individuals)","CREDIT","CONTRIBUTION","","","","$2.00 USD",2,-0.38,1.42,313.49,"USD","hledger","hledger","andre-bubel","Andre Bubel","STRIPE","CREDITCARD",,"",,,
"2019-05-01T05:33:18","0f1e3917","edf04139","Monthly contribution from Michael Martinides (Individuals)","CREDIT","CONTRIBUTION","","","","$2.00 USD",2,-0.38,1.42,312.07,"USD","hledger","hledger","michael-martinides","Michael Martinides","STRIPE","CREDITCARD",,"",,,
"2019-04-28T12:56:13","4563cb4b","3a6bfba3","Monthly contribution from Michael Martinides (Individuals)","CREDIT","CONTRIBUTION","","","","$2.00 USD",2,-0.38,1.42,310.65,"USD","hledger","hledger","michael-martinides","Michael Martinides","STRIPE","CREDITCARD",,"",,,
"2019-04-04T20:57:36","d31b4bb0","ec4c7a9e","Monthly contribution from Andre Bubel (Individuals)","CREDIT","CONTRIBUTION","","","","$2.00 USD",2,-0.38,1.42,309.23,"USD","hledger","hledger","andre-bubel","Andre Bubel","STRIPE","CREDITCARD",,"",,,
"2019-02-21T05:01:27","fb7323df","12bcd228","Monthly contribution from Simon Michael (Individuals)","CREDIT","CONTRIBUTION","","","","$10.00 USD",10,-0.59,8.41,307.81,"USD","hledger","hledger","simon","Simon Michael","STRIPE","CREDITCARD",,"",,,
"2019-01-21T05:01:00","7d1b5c6e","5e877620","Monthly contribution from Simon Michael (Individuals)","CREDIT","CONTRIBUTION","","","","$10.00 USD",10,-0.59,8.41,299.4,"USD","hledger","hledger","simon","Simon Michael","STRIPE","CREDITCARD",,"",,,
"2018-12-21T05:01:32","26df5099","28e59a50","Monthly contribution from Simon Michael (Individuals)","CREDIT","CONTRIBUTION","","","","$10.00 USD",10,-0.59,8.41,290.99,"USD","hledger","hledger","simon","Simon Michael","STRIPE","CREDITCARD",,"",,,
"2018-12-11T01:21:31","b7b603d4","fde280da","Contribution from Robert Nielsen","CREDIT","CONTRIBUTION","","","","$55.00 USD",55,-1.9,47.6,282.58,"USD","hledger","hledger","oldicelandic","Robert Nielsen","PAYPAL","PAYMENT",,"",,,
"2018-11-21T05:01:57","7ef6a6d5","115df4ff","Monthly contribution from Simon Michael (Individuals)","CREDIT","CONTRIBUTION","","","","$10.00 USD",10,-0.59,8.41,234.98,"USD","hledger","hledger","simon","Simon Michael","STRIPE","CREDITCARD",,"",,,
"2018-10-21T05:01:21","79c59f3c","e2c6a712","Monthly contribution from Simon Michael (Individuals)","CREDIT","CONTRIBUTION","","","","$10.00 USD",10,-0.59,8.41,226.57,"USD","hledger","hledger","simon","Simon Michael","STRIPE","CREDITCARD",,"",,,
"2018-09-21T05:01:41","95e4b042","643f7ce3","Monthly contribution from Simon Michael (Individuals)","CREDIT","CONTRIBUTION","","","","$10.00 USD",10,-0.59,8.41,218.16,"USD","hledger","hledger","simon","Simon Michael","STRIPE","CREDITCARD",,"",,,
"2018-08-21T05:00:40","223fc954","54b8487e","Monthly contribution from Simon Michael (Individuals)","CREDIT","CONTRIBUTION","","","","$10.00 USD",10,-0.59,8.41,209.75,"USD","hledger","hledger","simon","Simon Michael","STRIPE","CREDITCARD",,"",,,
"2018-07-21T05:01:06","5ea44648","c6f12978","Monthly contribution from Simon Michael (Individuals)","CREDIT","CONTRIBUTION","","","","$10.00 USD",10,-0.59,8.41,201.34,"USD","hledger","hledger","simon","Simon Michael","STRIPE","CREDITCARD",,"",,,
"2018-07-01T05:06:01","7585aa34","8b1b1247","Monthly contribution from Peter Simons (Individuals)","CREDIT","CONTRIBUTION","","","","$10.00 USD",10,-0.69,8.31,192.93,"USD","hledger","hledger","peti","Peter Simons","STRIPE","CREDITCARD",,"",,,
"2018-06-21T05:00:44","744bc15b","f462ee3b","Monthly contribution from Simon Michael (Individuals)","CREDIT","CONTRIBUTION","","","","$10.00 USD",10,-0.59,8.41,184.62,"USD","hledger","hledger","simon","Simon Michael","STRIPE","CREDITCARD",,"",,,
"2018-06-01T05:05:59","18cc93e7","3f6397b0","Monthly contribution from Peter Simons (Individuals)","CREDIT","CONTRIBUTION","","","","$10.00 USD",10,-0.69,8.31,176.21,"USD","hledger","hledger","peti","Peter Simons","STRIPE","CREDITCARD",,"",,,
"2018-05-21T05:00:49","60f9e4bb","a91945e8","Monthly contribution from Simon Michael (Individuals)","CREDIT","CONTRIBUTION","","","","$10.00 USD",10,-0.59,8.41,167.9,"USD","hledger","hledger","simon","Simon Michael","STRIPE","CREDITCARD",,"",,,
"2018-05-01T05:10:23","e8c85882","eb5fc1d2","Monthly contribution from Peter Simons (Individuals)","CREDIT","CONTRIBUTION","","","","$10.00 USD",10,-0.69,8.31,159.49,"USD","hledger","hledger","peti","Peter Simons","STRIPE","CREDITCARD",,"",,,
"2018-04-21T05:01:40","04f69e22","ccd3d7ea","Monthly contribution from Simon Michael (Individuals)","CREDIT","CONTRIBUTION","","","","$10.00 USD",10,-0.59,8.41,151.18,"USD","hledger","hledger","simon","Simon Michael","STRIPE","CREDITCARD",,"",,,
"2018-04-02T17:29:51","cff1c152","f77acb1e","Monthly contribution from Peter Simons (Individuals)","CREDIT","CONTRIBUTION","","","","$10.00 USD",10,-0.69,8.31,142.77,"USD","hledger","hledger","peti","Peter Simons","STRIPE","CREDITCARD",,"",,,
"2018-03-22T16:51:49","05ac4a31","a9460c9a","Monthly contribution from Peter Simons (Individuals)","CREDIT","CONTRIBUTION","","","","$10.00 USD",10,-0.69,8.31,134.46,"USD","hledger","hledger","peti","Peter Simons","STRIPE","CREDITCARD",,"",,,
"2018-03-21T20:21:59","fd038b3a","cfe7c41e","Monthly contribution from Simon Michael (Individuals)","CREDIT","CONTRIBUTION","","","","$10.00 USD",10,-0.59,8.41,126.15,"USD","hledger","hledger","simon","Simon Michael","STRIPE","CREDITCARD",,"",,,
"2018-02-21T21:48:37","969c2f34","80e6d4c9","Monthly contribution from Simon Michael (Individuals)","CREDIT","CONTRIBUTION","","","","$10.00 USD",10,-0.59,8.41,117.74,"USD","hledger","hledger","simon","Simon Michael","STRIPE","CREDITCARD",,"",,,
"2018-01-20T20:23:14","bdf31866","a482b234","Monthly contribution from Simon Michael (Individuals)","CREDIT","CONTRIBUTION","","","","$10.00 USD",10,-0.59,8.41,109.33,"USD","hledger","hledger","simon","Simon Michael","STRIPE","CREDITCARD",,"",,,
"2017-12-20T20:23:22","19139e92","f1c2d9db","Monthly contribution from Simon Michael (Individuals)","CREDIT","CONTRIBUTION","","","","$10.00 USD",10,-0.59,8.41,100.92,"USD","hledger","hledger","simon","Simon Michael","STRIPE","CREDITCARD",,"",,,
"2017-11-20T20:23:43","942487cb","e68cc861","Monthly contribution from Simon Michael (Individuals)","CREDIT","CONTRIBUTION","","","","$10.00 USD",10,-0.59,8.41,92.51,"USD","hledger","hledger","simon","Simon Michael","STRIPE","CREDITCARD",,"",,,
"2017-10-20T20:21:53","f704c73a","744fa3a7","Monthly contribution from Simon Michael (Individuals)","CREDIT","CONTRIBUTION","","","","$10.00 USD",10,-0.59,8.41,84.1,"USD","hledger","hledger","simon","Simon Michael","STRIPE","CREDITCARD",,"",,,
"2017-09-20T20:22:12","881f0581","c1d288a1","Monthly contribution from Simon Michael (Individuals)","CREDIT","CONTRIBUTION","","","","$10.00 USD",10,-0.59,8.41,75.69,"USD","hledger","hledger","simon","Simon Michael","STRIPE","CREDITCARD",,"",,,
"2017-08-20T20:22:12","98365cfa","0a06c3bd","Monthly contribution from Simon Michael (Individuals)","CREDIT","CONTRIBUTION","","","","$10.00 USD",10,-0.59,8.41,67.28,"USD","hledger","hledger","simon","Simon Michael","STRIPE","CREDITCARD",,"",,,
"2017-07-20T20:23:11","89bbe4cc","526e586c","Monthly contribution from Simon Michael (Individuals)","CREDIT","CONTRIBUTION","","","","$10.00 USD",10,-0.59,8.41,58.87,"USD","hledger","hledger","simon","Simon Michael","STRIPE","CREDITCARD",,"",,,
"2017-06-20T20:22:00","92c97790","aa3ada9f","Monthly contribution from Simon Michael (Individuals)","CREDIT","CONTRIBUTION","","","","$10.00 USD",10,-0.59,8.41,50.46,"USD","hledger","hledger","simon","Simon Michael","STRIPE","CREDITCARD",,"",,,
"2017-05-20T20:22:06","ab4e1e18","e045e2ce","Monthly contribution from Simon Michael (Individuals)","CREDIT","CONTRIBUTION","","","","$10.00 USD",10,-0.59,8.41,42.05,"USD","hledger","hledger","simon","Simon Michael","STRIPE","CREDITCARD",,"",,,
"2017-04-20T20:22:58","87df89cf","63fea57e","Monthly contribution from Simon Michael (Individuals)","CREDIT","CONTRIBUTION","","","","$10.00 USD",10,-0.59,8.41,33.64,"USD","hledger","hledger","simon","Simon Michael","STRIPE","CREDITCARD",,"",,,
"2017-03-20T20:25:44","7e83913a","785604f8","Monthly contribution from Simon Michael (Individuals)","CREDIT","CONTRIBUTION","","","","$10.00 USD",10,-0.59,8.41,25.23,"USD","hledger","hledger","simon","Simon Michael","STRIPE","CREDITCARD",,"",,,
"2017-02-20T20:22:07","fe0ead37","197d11a4","Monthly contribution from Simon Michael (Individuals)","CREDIT","CONTRIBUTION","","","","$10.00 USD",10,-0.59,8.41,16.82,"USD","hledger","hledger","simon","Simon Michael","STRIPE","CREDITCARD",,"",,,
"2017-01-20T19:21:45","f50dc2b7","8b272eb0","Monthly contribution from Simon Michael (Individuals)","CREDIT","CONTRIBUTION","","","","$10.00 USD",10,-0.59,8.41,8.41,"USD","hledger","hledger","simon","Simon Michael","STRIPE","CREDITCARD",,"",,,
